,game_id,Team,year,region,PTS,REB,AST,FGM,FGA,2PM,2PA,3PM,3PA,FTM,FTA,OR,DR,PF,ST,TO,BS,BA,TFS
0,06e9UWdR,COB,2022,bal,4,6,4,1,10,1,6,0,4,2,4,3,3,1,3,4,2,0,0
1,06e9UWdR,ZAM,2022,bal,70,35,19,28,70,19,35,9,35,5,11,11,24,18,9,11,7,0,0
2,08MbGrhf,IGO,2021,euro,75,34,12,30,65,22,43,8,22,7,9,10,24,17,11,12,1,0,0
3,08MbGrhf,PAO,2021,euro,64,30,12,26,58,20,36,6,22,6,9,6,24,13,6,17,1,0,0
4,0ABA9VK1,DUC,2022,bal,62,28,19,24,69,18,43,6,26,8,9,13,15,25,6,15,0,7,0
5,0ABA9VK1,USM,2022,bal,74,42,17,26,59,22,35,4,24,18,24,14,28,11,5,19,7,0,0
6,0APDJvKI,DIJ,2023,euro,71,36,13,23,69,16,40,7,29,18,23,12,24,21,15,15,2,0,0
7,0APDJvKI,PRO,2023,euro,68,32,17,25,54,19,33,6,21,12,24,6,26,23,9,21,5,0,0
8,0C2vOES1,BUR,2023,euro,74,28,8,23,56,14,33,9,23,19,20,5,23,18,8,14,4,0,0
9,0C2vOES1,HAP,2023,euro,93,33,19,35,67,24,43,11,24,12,19,10,23,16,9,9,2,0,0
10,0GdqWorn,ALA,2023,bal,91,34,20,31,63,22,40,9,23,20,22,7,27,22,9,17,3,3,0
11,0GdqWorn,CAP,2023,bal,75,28,12,29,68,26,48,3,20,14,19,9,19,18,9,17,3,3,0
12,0OCEPdl2,DAR,2021,euro,75,28,18,26,55,19,34,7,21,16,23,8,20,19,6,8,7,0,0
13,0OCEPdl2,TOF,2021,euro,74,35,18,27,63,20,38,7,25,13,18,12,23,24,3,11,2,0,0
14,0UZiM847,COB,2022,bal,108,38,29,39,73,27,44,12,29,18,25,10,28,24,5,17,4,0,0
15,0UZiM847,ESP,2022,bal,82,45,12,28,77,21,50,7,27,19,33,22,23,22,8,15,2,0,0
16,0WEPlBLl,CLU,2021,euro,79,33,14,28,61,22,41,6,20,17,22,12,21,25,11,18,3,0,0
17,0WEPlBLl,UNI,2021,euro,73,24,17,23,57,13,27,10,30,17,23,8,16,21,7,16,7,0,0
18,0bHUtdO7,MAN,2021,euro,86,43,22,28,63,15,34,13,29,17,22,8,35,15,7,15,2,0,0
19,0bHUtdO7,UNI,2021,euro,63,33,14,23,69,16,40,7,29,10,13,10,23,25,6,18,5,0,0
20,0fNbWSjC,DIJ,2022,euro,89,27,22,35,60,28,40,7,20,12,14,2,25,22,7,15,0,0,0
21,0fNbWSjC,PER,2022,euro,80,27,17,30,64,23,40,7,24,13,18,8,19,18,11,12,4,0,0
22,0fVNEJBR,RIV,2021,bal,70,37,16,25,64,19,41,6,23,14,20,9,28,13,5,19,7,5,0
23,0fVNEJBR,USM,2021,bal,99,31,27,37,76,22,45,15,31,10,15,6,25,21,10,9,5,7,0
24,0hlL069c,BRE,2023,euro,80,24,21,27,49,18,26,9,23,17,26,4,20,25,9,13,2,0,0
25,0hlL069c,PIN,2023,euro,73,34,19,22,60,18,33,4,27,25,30,15,19,24,10,13,3,0,0
26,0jVcquxG,MUR,2022,euro,74,29,10,22,55,12,28,10,27,20,31,7,22,24,5,12,0,0,0
27,0jVcquxG,UNI,2022,euro,96,31,22,35,63,23,38,12,25,14,18,5,26,27,3,8,2,0,0
28,0jotvklA,MAN,2021,euro,103,24,30,35,64,24,40,11,24,22,28,4,20,21,13,12,2,0,0
29,0jotvklA,TRE,2021,euro,88,39,19,32,67,22,43,10,24,14,18,13,26,22,6,21,2,0,0
30,0p01tg83,CAP,2023,bal,69,40,15,23,67,14,35,9,32,14,22,7,33,17,6,19,3,10,0
31,0p01tg83,STA,2023,bal,78,45,21,31,73,25,48,6,25,10,21,11,34,21,13,17,10,3,0
32,0vkPST5A,BES,2021,euro,73,26,11,27,58,18,34,9,24,10,12,9,17,21,8,11,2,0,0
33,0vkPST5A,HAP,2021,euro,72,32,19,24,58,14,27,10,31,14,19,14,18,19,6,15,4,0,0
34,0xM2S82j,BAN,2023,euro,97,25,22,33,62,21,38,12,24,19,20,7,18,19,11,16,1,0,0
35,0xM2S82j,SZC,2023,euro,81,24,17,30,55,19,32,11,23,10,11,3,21,21,8,25,1,0,0
36,21SyxNSd,PAO,2023,euro,71,27,11,25,59,17,32,8,27,13,18,7,20,25,6,7,1,0,0
37,21SyxNSd,TOF,2023,euro,84,40,16,26,58,14,30,12,28,20,25,11,29,20,5,12,5,0,0
38,231F59ng,BNE,2022,euro,101,35,21,39,78,30,50,9,28,14,18,14,21,20,9,9,7,0,0
39,231F59ng,RYT,2022,euro,90,37,15,29,72,20,49,9,23,23,27,15,22,22,2,14,4,0,0
40,23HkAwKr,FER,2021,bal,86,46,24,27,69,24,51,3,18,29,41,13,33,15,8,16,3,2,0
41,23HkAwKr,PET,2021,bal,73,34,14,30,73,23,49,7,24,6,14,8,26,34,7,18,2,3,0
42,23eD5u18,MAN,2021,euro,74,27,14,27,48,17,26,10,22,10,12,9,18,18,7,12,0,0,0
43,23eD5u18,UNI,2021,euro,89,24,19,33,65,22,36,11,29,12,17,9,15,21,5,11,1,0,0
44,27X48gun,MUR,2022,euro,82,33,21,32,59,24,40,8,19,10,11,6,27,21,4,11,4,0,0
45,27X48gun,TEN,2022,euro,67,33,15,23,65,19,39,4,26,17,23,14,19,17,8,11,4,0,0
46,27ot27T5,DOU,2023,bal,74,44,16,29,73,26,55,3,18,13,22,17,27,21,11,18,5,5,0
47,27ot27T5,STA,2023,bal,58,42,15,22,68,19,44,3,24,11,20,17,25,19,12,22,5,5,0
48,29IKSZlr,BAH,2022,euro,60,32,10,25,66,20,37,5,29,5,8,14,18,21,4,13,3,0,0
49,29IKSZlr,BIL,2022,euro,92,32,26,33,58,25,37,8,21,18,25,8,24,17,6,9,3,0,0
50,2DjU03h7,BES,2021,euro,88,33,21,33,62,25,47,8,15,14,16,6,27,19,3,8,6,0,0
51,2DjU03h7,OLD,2021,euro,72,26,17,24,57,19,36,5,21,19,24,5,21,17,2,8,4,0,0
52,2LQEG6ra,CAP,2023,bal,75,43,9,25,68,20,49,5,19,20,30,11,32,20,7,12,4,2,0
53,2LQEG6ra,SLA,2023,bal,68,38,10,24,66,19,45,5,21,15,23,11,27,25,10,15,2,4,0
54,2Ph82Gfb,BAN,2023,euro,77,23,18,28,60,18,36,10,24,11,16,5,18,20,6,16,1,0,0
55,2Ph82Gfb,CHO,2023,euro,93,37,21,35,69,21,36,14,33,9,16,12,25,22,9,11,3,0,0
56,2TjcltR2,DAR,2021,euro,89,38,18,33,69,26,50,7,19,16,19,15,23,17,5,10,4,0,0
57,2TjcltR2,MAN,2021,euro,84,27,23,30,63,16,33,14,30,10,17,8,19,17,6,13,1,0,0
58,2XlXXBBo,PET,2023,bal,65,42,14,25,66,19,41,6,25,9,11,5,37,18,8,24,1,0,0
59,2XlXXBBo,STA,2023,bal,73,39,24,29,71,23,44,6,27,9,20,5,34,13,13,15,5,0,0
60,2ZeqTgGs,HAP,2022,euro,69,24,8,23,48,14,32,9,16,14,18,5,19,20,6,14,3,0,0
61,2ZeqTgGs,TEN,2022,euro,68,26,19,25,56,20,34,5,22,13,18,9,17,19,11,11,2,0,0
62,2ZszwJIn,PER,2023,euro,88,26,20,33,67,24,39,9,28,13,18,7,19,22,6,5,3,0,0
63,2ZszwJIn,PIN,2023,euro,93,38,19,31,61,19,36,12,25,19,23,10,28,21,3,12,3,0,0
64,2g0a2994,RYT,2021,euro,71,29,20,26,57,20,35,6,22,13,18,9,20,13,12,15,5,0,0
65,2g0a2994,STR,2021,euro,76,29,13,32,66,22,40,10,26,2,2,11,18,21,8,14,4,0,0
66,2sUB717q,HAP,2021,euro,71,29,13,24,62,14,31,10,31,13,17,10,19,23,6,11,1,0,0
67,2sUB717q,TEN,2021,euro,78,40,12,29,61,24,43,5,18,15,24,13,27,18,8,14,1,0,0
68,2uP9wfSl,BUR,2023,euro,75,37,11,25,57,16,30,9,27,16,22,8,29,20,2,9,2,0,0
69,2uP9wfSl,HAP,2023,euro,74,34,20,26,66,18,43,8,23,14,19,8,26,20,5,6,1,0,0
70,2y98be4E,HAP,2023,euro,71,34,14,22,50,15,27,7,23,20,34,9,25,19,7,15,1,0,0
71,2y98be4E,PAO,2023,euro,61,26,16,20,54,13,31,7,23,14,20,5,21,28,7,14,1,0,0
72,42WhSxtR,FAP,2021,bal,64,39,11,19,74,12,41,7,33,19,28,16,23,20,13,14,1,3,0
73,42WhSxtR,PET,2021,bal,66,37,11,23,56,13,23,10,33,10,13,5,32,21,9,26,3,1,0
74,4Qzkqkji,LAV,2021,euro,72,26,8,25,56,17,31,8,25,14,19,7,19,22,3,11,4,0,0
75,4Qzkqkji,TRE,2021,euro,87,32,18,32,61,20,37,12,24,11,17,9,23,17,6,9,2,0,0
76,4STkYlMa,AEK,2022,euro,73,27,21,22,49,13,22,9,27,20,26,7,20,20,7,13,3,0,0
77,4STkYlMa,TOF,2022,euro,70,28,14,25,57,15,33,10,24,10,16,10,18,23,6,17,2,0,0
78,4fA5AvW4,STR,2023,euro,70,29,14,26,58,21,43,5,15,13,18,11,18,18,4,12,0,0,0
79,4fA5AvW4,UNI,2023,euro,79,25,16,30,56,19,31,11,25,8,13,9,16,21,8,11,6,0,0
80,4fd2hHWu,DOU,2023,bal,92,37,15,28,60,21,33,7,27,29,35,10,27,25,11,18,5,3,0
81,4fd2hHWu,PET,2023,bal,86,30,21,29,68,16,33,13,35,15,22,10,20,22,10,22,3,5,0
82,4he0fX9D,DIJ,2021,euro,83,19,19,29,61,17,34,12,27,13,14,4,15,24,5,10,0,0,0
83,4he0fX9D,HAP,2021,euro,90,31,21,28,55,19,31,9,24,25,30,5,26,17,6,10,1,0,0
84,4hmEpbQR,RYT,2021,euro,75,31,8,26,61,17,34,9,27,14,22,16,15,24,6,16,1,0,0
85,4hmEpbQR,TEN,2021,euro,89,27,22,31,55,19,28,12,27,15,22,6,21,22,10,16,3,0,0
86,4nfeLLnD,BC,2021,euro,72,30,19,27,60,20,43,7,17,11,14,12,18,16,5,15,0,0,0
87,4nfeLLnD,IGO,2021,euro,87,29,18,36,65,27,42,9,23,6,11,10,19,20,7,8,5,0,0
88,4tmEVf9S,LUD,2021,euro,55,39,7,20,70,16,44,4,26,11,20,16,23,22,10,10,1,0,0
89,4tmEVf9S,MAN,2021,euro,63,49,12,22,60,19,45,3,15,16,27,18,31,20,5,17,1,0,0
90,4v20WhSE,FER,2022,bal,89,31,18,35,73,28,52,7,21,12,20,12,19,13,15,14,1,5,0
91,4v20WhSE,REG,2022,bal,94,37,28,32,64,12,28,20,36,10,13,11,26,13,8,23,5,1,0
92,4v4R15kg,DIJ,2022,euro,72,24,14,28,61,25,44,3,17,13,14,7,17,18,8,13,2,0,0
93,4v4R15kg,STR,2022,euro,85,29,23,36,58,30,44,6,14,7,12,7,22,21,7,12,2,0,0
94,4xZuufh5,MAN,2023,euro,68,37,16,23,71,14,39,9,32,13,18,15,22,17,7,10,3,0,0
95,4xZuufh5,PRO,2023,euro,78,28,17,28,60,16,30,12,30,10,10,5,23,19,4,11,4,0,0
96,61ZutIYr,SZO,2021,euro,62,33,16,27,64,25,49,2,15,6,6,14,19,14,8,17,5,0,0
97,61ZutIYr,TEN,2021,euro,87,26,28,30,57,14,28,16,29,11,12,6,20,11,10,14,1,0,0
98,6DVV8N50,SZO,2023,euro,65,25,14,21,52,13,29,8,23,15,22,3,22,22,3,20,0,0,0
99,6DVV8N50,UNI,2023,euro,88,41,26,34,73,29,46,5,27,15,18,11,30,20,9,13,4,0,0
100,6FMbTlmp,AEK,2023,euro,79,40,14,26,63,22,42,4,21,23,38,14,26,27,7,16,3,0,0
101,6FMbTlmp,LUD,2023,euro,83,27,16,26,70,18,41,8,29,23,32,10,17,31,6,8,4,0,0
102,6N0csZhc,ALA,2023,bal,94,34,17,33,64,21,33,12,31,16,19,10,24,19,6,18,0,2,0
103,6N0csZhc,REG,2023,bal,77,24,19,26,64,15,30,11,34,14,18,9,15,22,10,15,2,0,0
104,6NfjwLKc,MUR,2022,euro,87,31,15,24,55,11,22,13,33,26,28,9,22,26,5,18,2,0,0
105,6NfjwLKc,TOF,2022,euro,77,28,19,27,58,23,41,4,17,19,28,8,20,24,13,14,0,0,0
106,6T5zcwsT,BAH,2022,euro,76,28,17,27,64,16,37,11,27,11,18,9,19,20,9,15,3,0,0
107,6T5zcwsT,BON,2022,euro,87,36,22,31,66,22,43,9,23,16,17,13,23,21,7,13,3,0,0
108,6mnuz04a,DAR,2023,euro,63,35,13,26,72,19,44,7,28,4,8,9,26,22,7,13,1,0,0
109,6mnuz04a,TEN,2023,euro,72,35,20,24,53,14,25,10,28,14,20,2,33,19,5,15,5,0,0
110,6o3cBcse,GAL,2021,euro,89,28,19,31,72,16,38,15,28,12,16,7,21,20,7,7,1,0,0
111,6o3cBcse,HAP,2021,euro,98,33,21,34,61,22,35,12,26,18,24,7,26,19,5,8,3,0,0
112,6oyjmpO7,BC,2021,euro,78,29,17,24,50,12,26,12,24,18,23,7,22,24,1,15,4,0,0
113,6oyjmpO7,TOF,2021,euro,83,36,12,29,73,22,46,7,27,18,23,18,18,19,10,6,1,0,0
114,6qrIbnoD,BC,2021,euro,86,31,19,30,53,17,32,13,21,13,19,4,27,21,2,17,2,0,0
115,6qrIbnoD,UNI,2021,euro,68,25,18,26,62,19,37,7,25,9,14,8,17,18,9,13,3,0,0
116,6qroruR0,HAP,2022,euro,142,57,31,54,127,33,68,21,59,13,19,15,42,33,11,23,13,0,0
117,6ynLfbKe,DOU,2021,bal,94,33,23,35,75,23,48,12,27,12,14,8,25,25,11,11,6,2,0
118,6ynLfbKe,PET,2021,bal,76,43,16,26,64,21,46,5,18,19,30,15,28,16,8,21,2,6,0
119,80zUFCmJ,HAP,2022,euro,81,29,22,33,58,26,36,7,22,8,16,7,22,19,4,12,0,0,0
120,80zUFCmJ,STR,2022,euro,80,30,20,29,61,18,38,11,23,11,13,9,21,19,8,11,1,0,0
121,84hXQ7zN,DAR,2021,euro,78,35,15,29,68,19,37,10,31,10,20,12,23,19,9,9,1,0,0
122,84hXQ7zN,SAN,2021,euro,83,36,19,27,65,16,34,11,31,18,22,9,27,19,5,13,4,0,0
123,863OLRyb,BON,2022,euro,90,36,20,35,71,25,48,10,23,10,14,11,25,18,8,7,1,0,0
124,863OLRyb,REG,2022,euro,66,28,16,22,55,14,31,8,24,14,21,8,20,18,2,10,5,0,0
125,886goBFg,HAP,2021,euro,81,20,12,30,59,21,32,9,27,12,14,1,19,17,10,15,7,0,0
126,886goBFg,STR,2021,euro,80,45,13,30,76,22,53,8,23,12,15,21,24,18,7,13,2,0,0
127,8AsKNQaK,BAN,2021,euro,63,29,15,23,61,19,42,4,19,13,15,10,19,24,4,15,1,0,0
128,8AsKNQaK,TEN,2021,euro,84,27,18,26,51,14,25,12,26,20,24,3,24,17,9,9,1,0,0
129,8C6xcKxi,HAP,2021,euro,75,31,9,25,60,19,39,6,21,19,26,9,22,20,7,11,5,0,0
130,8C6xcKxi,PRO,2021,euro,71,23,11,31,66,20,35,11,31,12,15,7,24,24,8,8,3,0,0
131,8CWVGDSR,ASS,2022,bal,95,35,24,34,65,19,35,15,30,12,16,8,27,19,7,14,6,1,0
132,8CWVGDSR,FER,2022,bal,84,38,21,30,74,21,48,9,26,15,23,15,23,19,9,10,1,6,0
133,8EcL2PNf,NIZ,2021,euro,69,22,23,25,60,22,42,3,18,16,22,7,15,23,6,14,1,0,0
134,8EcL2PNf,UNI,2021,euro,93,30,23,35,58,25,35,10,23,13,16,6,24,23,11,17,2,0,0
135,8KQ6U6LO,PAO,2022,euro,62,21,10,22,64,17,35,5,29,13,16,8,13,18,14,12,0,0,0
136,8KQ6U6LO,RYT,2022,euro,85,41,20,33,61,26,41,7,20,12,14,11,30,20,4,18,6,0,0
137,8Q1idgu1,DIJ,2021,euro,81,30,16,30,60,21,37,9,23,11,13,6,24,16,12,14,3,0,0
138,8Q1idgu1,GAL,2021,euro,75,40,22,27,62,21,40,6,22,9,12,12,29,15,11,19,3,0,0
139,8Qg5nKeF,SZO,2021,euro,73,25,18,28,59,23,45,5,14,12,15,8,17,22,9,12,2,0,0
140,8Qg5nKeF,TEN,2021,euro,79,26,20,26,57,14,24,12,33,15,15,10,16,15,7,15,3,0,0
141,8SSTM5pO,AEK,2023,euro,68,31,9,22,57,16,39,6,18,18,24,9,22,24,5,14,2,0,0
142,8SSTM5pO,HAP,2023,euro,79,30,21,27,61,17,34,10,27,15,21,7,23,25,10,7,6,0,0
143,8b1Zx3Hj,PAO,2023,euro,88,36,26,31,69,19,37,12,32,14,19,7,29,29,3,16,5,0,0
144,8b1Zx3Hj,TOF,2023,euro,87,42,15,26,77,16,45,10,32,25,34,15,27,19,7,12,5,0,0
145,8jFYBT08,LUD,2021,euro,99,33,13,34,71,22,45,12,26,19,22,13,20,18,8,5,4,0,0
146,8jFYBT08,TEN,2021,euro,83,29,17,30,63,22,38,8,25,15,17,9,20,19,3,14,5,0,0
147,8t82y5aH,TOF,2023,euro,70,22,13,20,57,12,29,8,28,22,27,4,18,17,3,5,3,0,0
148,8t82y5aH,UNI,2023,euro,89,39,23,35,66,25,41,10,25,9,13,7,32,27,1,7,1,0,0
149,8tn6R2oa,USM,2021,bal,63,33,12,21,66,17,43,4,23,17,26,13,20,17,8,17,4,5,0
150,8tn6R2oa,ZAM,2021,bal,76,33,15,31,62,24,38,7,24,7,12,7,26,26,5,18,5,4,0
151,A3qHMxGm,ESP,2022,bal,62,45,15,23,68,16,40,7,27,9,16,12,33,17,7,30,1,0,0
152,A3qHMxGm,PET,2022,bal,66,25,23,24,52,19,30,5,22,13,21,3,22,14,14,11,6,0,0
153,A5xBHLR8,ASP,2021,bal,66,26,15,25,67,18,38,7,29,9,12,7,19,20,6,20,1,5,0
154,A5xBHLR8,PET,2021,bal,84,51,19,29,78,18,35,11,43,15,22,22,29,20,10,18,5,1,0
155,A75cRNdH,CAP,2023,bal,80,37,19,28,63,19,35,9,28,15,19,5,32,22,5,12,0,1,0
156,A75cRNdH,CIT,2023,bal,70,36,13,22,64,13,28,9,36,17,26,6,30,20,6,11,1,0,0
157,A7m0Tk1t,BON,2023,euro,80,26,16,29,55,22,36,7,19,15,28,6,20,22,5,11,0,0,0
158,A7m0Tk1t,LUD,2023,euro,75,35,11,24,62,19,36,5,26,22,26,12,23,24,7,10,1,0,0
159,A9xxhjIg,DIJ,2022,euro,69,28,22,28,66,22,45,6,21,7,7,6,22,18,9,10,3,0,0
160,A9xxhjIg,PAO,2022,euro,74,28,14,24,51,11,22,13,29,13,17,2,26,15,7,12,3,0,0
161,AH2yQnIh,BC,2023,euro,87,30,16,26,59,14,30,12,29,23,29,6,24,30,3,11,2,0,0
162,AH2yQnIh,STR,2023,euro,84,35,15,27,66,19,41,8,25,22,27,14,21,28,8,13,2,0,0
163,AL8fYbj9,BC,2023,euro,64,33,14,19,54,10,17,9,37,17,22,11,22,20,10,14,2,0,0
164,AL8fYbj9,OLD,2023,euro,81,31,19,30,62,18,37,12,25,9,14,9,22,20,6,13,0,0,0
165,ALIcCXzq,ASS,2022,bal,90,26,19,30,69,15,32,15,37,15,19,8,18,19,7,11,1,3,0
166,ALIcCXzq,USM,2022,bal,96,35,31,34,62,22,36,12,26,16,19,8,27,21,7,14,3,1,0
167,ALW0Mtz0,PRO,2023,euro,75,32,19,29,72,22,46,7,26,10,13,13,19,23,7,10,1,0,0
168,ALW0Mtz0,RYT,2023,euro,77,35,17,25,58,19,36,6,22,21,25,11,24,21,4,15,4,0,0
169,AP4kgjbP,BAH,2022,euro,77,29,17,28,50,20,30,8,20,13,16,3,26,17,4,14,3,0,0
170,AP4kgjbP,BC,2022,euro,64,23,14,25,54,19,29,6,25,8,12,3,20,18,7,11,1,0,0
171,APjalBt7,IGO,2023,euro,84,38,19,32,68,29,47,3,21,17,23,14,24,22,6,15,1,0,0
172,APjalBt7,TOR,2023,euro,91,28,21,27,61,18,39,9,22,28,32,8,20,19,10,8,3,0,0
173,AVasK1tK,BCK,2021,euro,72,32,17,25,56,20,33,5,23,17,21,11,21,16,8,16,0,0,0
174,AVasK1tK,TOF,2021,euro,70,21,19,26,53,17,28,9,25,9,12,5,16,19,6,16,7,0,0
175,AXll0obI,DOU,2023,bal,75,35,19,29,61,21,39,8,22,9,14,7,28,18,6,19,9,4,0
176,AXll0obI,KWA,2023,bal,68,33,12,24,71,14,44,10,27,10,14,11,22,15,10,16,4,9,0
177,AZmW1RoI,BIL,2022,euro,71,37,14,24,69,16,40,8,29,15,20,10,27,17,4,11,4,0,0
178,AZmW1RoI,NYM,2022,euro,81,39,15,33,72,21,45,12,27,3,7,9,30,23,6,9,5,0,0
179,AoUMEpDB,FER,2023,bal,76,29,14,27,59,20,38,7,21,15,22,8,21,25,6,24,1,2,0
180,AoUMEpDB,PET,2023,bal,101,33,30,32,68,20,33,12,35,25,31,10,23,24,10,11,2,1,0
181,Aq9LNdlr,ASP,2021,bal,79,46,22,27,82,20,52,7,30,18,27,16,30,18,7,18,4,5,0
182,Aq9LNdlr,ASS,2021,bal,88,56,18,33,83,28,64,5,19,17,24,18,38,25,10,20,5,4,0
183,AqcZerOS,BC,2023,euro,71,38,12,25,55,13,30,12,25,9,14,8,30,24,9,13,0,0,0
184,AqcZerOS,HAP,2023,euro,61,36,6,19,60,15,41,4,19,19,24,15,21,14,4,10,1,0,0
185,AspVpxzF,BRE,2023,euro,82,28,14,28,59,20,39,8,20,18,29,9,19,19,10,11,5,0,0
186,AspVpxzF,HAP,2023,euro,72,40,21,28,63,19,39,9,24,7,13,15,25,21,7,15,5,0,0
187,CAjrbNlI,DIJ,2022,euro,81,35,20,29,74,18,37,11,37,12,16,13,22,21,6,12,2,0,0
188,CAjrbNlI,HAP,2022,euro,88,31,21,33,60,22,38,11,22,11,20,4,27,18,9,14,2,0,0
189,CE4Qoc3B,AEK,2023,euro,110,34,33,36,62,24,40,12,22,26,31,9,25,14,15,13,4,0,0
190,CE4Qoc3B,BAN,2023,euro,79,20,24,29,62,15,26,14,36,7,12,7,13,20,8,20,3,0,0
191,CKDD8I0H,BON,2023,euro,72,29,20,26,60,18,35,8,25,12,15,8,21,22,8,8,2,0,0
192,CKDD8I0H,DIJ,2023,euro,62,34,7,22,56,19,34,3,22,15,17,9,25,21,3,14,2,0,0
193,CMrEaSV6,BC,2021,euro,75,30,16,32,65,24,42,8,23,3,4,6,24,20,6,13,3,0,0
194,CMrEaSV6,CLU,2021,euro,86,27,21,31,60,19,30,12,30,12,17,3,24,19,6,10,1,0,0
195,CYjHlA6t,DIJ,2022,euro,88,38,26,29,65,17,33,12,32,18,23,13,25,26,4,15,3,0,0
196,CYjHlA6t,PER,2022,euro,92,33,25,28,67,18,37,10,30,26,32,15,18,21,10,11,2,0,0
197,CbYP8Y4a,CHO,2023,euro,74,35,16,26,67,17,39,9,28,13,18,13,22,17,5,18,0,0,0
198,CbYP8Y4a,UNI,2023,euro,86,35,23,32,66,22,44,10,22,12,14,10,25,20,12,13,4,0,0
199,Chq1i2Wq,GAL,2023,euro,95,32,26,29,60,16,29,13,31,24,28,9,23,25,3,7,5,0,0
200,Chq1i2Wq,TOR,2023,euro,89,37,13,29,72,16,41,13,31,18,22,15,22,22,3,7,1,0,0
201,CnMgWXXa,BIL,2022,euro,72,26,14,25,58,14,30,11,28,11,14,7,19,20,6,10,5,0,0
202,CnMgWXXa,TEN,2022,euro,74,25,13,25,57,16,27,9,30,15,17,8,17,21,8,10,2,0,0
203,CpFE8kz8,REG,2022,bal,77,31,23,27,69,17,39,10,30,13,18,9,22,21,5,9,4,3,0
204,CpFE8kz8,USM,2022,bal,74,38,16,29,59,21,38,8,21,8,11,8,30,19,5,19,3,4,0
205,CpwNIZcF,DUC,2022,bal,92,30,17,31,74,17,41,14,33,16,29,11,19,25,8,10,2,0,0
206,CpwNIZcF,FER,2022,bal,98,41,20,33,62,25,42,8,20,24,30,9,32,22,3,18,0,2,0
207,CtH73Nco,BAH,2022,euro,68,32,8,23,57,16,38,7,19,15,18,11,21,11,3,7,2,0,0
208,CtH73Nco,BON,2022,euro,74,35,14,28,64,16,33,12,31,6,9,12,23,23,4,9,5,0,0
209,CxNQqG5l,CHO,2023,euro,85,31,21,29,58,19,27,10,31,17,19,9,22,18,7,12,1,0,0
210,CxNQqG5l,TEN,2023,euro,91,23,20,32,58,15,23,17,35,10,13,3,20,18,5,11,0,0,0
211,E3f1m0t9,DAR,2021,euro,85,24,17,28,62,20,41,8,21,21,28,6,18,22,15,11,2,0,0
212,E3f1m0t9,TRE,2021,euro,81,36,19,28,58,17,34,11,24,14,19,12,24,24,6,19,2,0,0
213,E7A2Sb4q,DAR,2021,euro,81,29,23,23,60,16,39,7,21,28,33,10,19,20,9,13,4,0,0
214,E7A2Sb4q,TOF,2021,euro,91,31,22,31,62,19,36,12,26,17,18,10,21,25,9,15,1,0,0
215,EDypOUZf,COB,2022,bal,56,41,12,19,62,15,39,4,23,14,32,14,27,15,12,26,3,3,0
216,EDypOUZf,PET,2022,bal,92,40,27,33,74,25,38,8,36,18,21,11,29,21,19,14,3,3,0
217,EH3Qc4gG,BC,2023,euro,70,27,11,24,59,16,37,8,22,14,20,9,18,23,6,15,4,0,0
218,EH3Qc4gG,HAP,2023,euro,80,28,18,27,53,23,38,4,15,22,32,7,21,20,9,13,3,0,0
219,EHynrqfQ,PAO,2021,euro,79,31,12,27,58,21,37,6,21,19,26,9,22,24,5,11,1,0,0
220,EHynrqfQ,STR,2021,euro,80,29,10,26,54,14,25,12,29,16,20,7,22,25,7,14,1,0,0
221,EJn2SrWh,PAT,2021,bal,68,39,16,23,72,13,36,10,36,12,15,18,21,16,8,18,2,4,0
222,EJn2SrWh,PET,2021,bal,97,39,27,33,72,13,28,20,44,11,14,14,25,15,11,14,4,2,0
223,EPZGebe0,AEK,2022,euro,92,32,18,31,62,21,37,10,25,20,24,7,25,21,7,8,2,0,0
224,EPZGebe0,GAL,2022,euro,78,29,13,27,56,17,33,10,23,14,19,5,24,18,4,14,3,0,0
225,EPcsFGKr,GAL,2022,euro,90,33,27,31,67,16,34,15,33,13,19,10,23,17,10,14,4,0,0
226,EPcsFGKr,LEG,2022,euro,76,41,19,29,69,23,47,6,22,12,18,17,24,18,8,14,4,0,0
227,ERxlvd3e,RYT,2021,euro,64,29,15,23,61,15,34,8,27,10,11,13,16,16,5,11,0,0,0
228,ERxlvd3e,TEN,2021,euro,83,31,18,31,56,21,29,10,27,11,16,10,21,15,3,12,4,0,0
229,ETHXAUI9,USM,2022,bal,88,32,16,27,62,20,37,7,25,27,34,7,25,28,7,11,5,1,0
230,ETHXAUI9,ZAM,2022,bal,81,37,12,23,63,14,32,9,31,26,36,10,27,28,1,17,1,5,0
231,EXy4DtxD,OST,2021,euro,69,24,17,22,58,13,29,9,29,16,20,10,14,15,11,12,2,0,0
232,EXy4DtxD,PIN,2021,euro,86,38,20,32,57,21,32,11,25,11,16,12,26,20,7,16,5,0,0
233,EZdQRad6,SLA,2022,bal,49,48,7,21,64,20,45,1,19,6,10,13,35,19,7,23,7,0,0
234,EZdQRad6,ZAM,2022,bal,66,42,16,23,72,14,32,9,40,11,24,18,24,18,12,16,0,7,0
235,Ecq1eBXH,BAN,2023,euro,91,26,21,32,59,19,30,13,29,14,19,5,21,22,6,11,2,0,0
236,Ecq1eBXH,CHO,2023,euro,95,25,17,33,63,16,24,17,39,12,15,5,20,18,7,10,0,0,0
237,EeEIctp7,BC,2021,euro,83,28,19,27,43,18,26,9,17,20,25,2,26,19,3,19,3,0,0
238,EeEIctp7,IGO,2021,euro,77,21,20,31,66,24,47,7,19,8,17,9,12,26,9,8,1,0,0
239,EibH358l,DAR,2021,euro,57,34,13,21,61,15,41,6,20,9,11,12,22,22,8,17,2,0,0
240,EibH358l,HAP,2021,euro,64,30,18,24,54,19,37,5,17,11,16,4,26,19,9,15,4,0,0
241,Ek9SR8mt,PIN,2023,euro,65,29,16,23,52,15,28,8,24,11,16,7,22,24,4,18,8,0,0
242,Ek9SR8mt,STR,2023,euro,80,35,20,27,63,18,42,9,21,17,20,12,23,20,6,10,2,0,0
243,EqUKF8RN,LIM,2022,euro,96,26,16,30,57,25,36,5,21,31,36,3,23,21,8,11,4,0,0
244,EqUKF8RN,LUD,2022,euro,94,30,21,30,67,20,38,10,29,24,28,8,22,26,7,10,1,0,0
245,EuClTqS4,CIT,2023,bal,96,33,21,36,70,21,40,15,30,9,19,11,22,20,8,14,2,4,0
246,EuClTqS4,FER,2023,bal,75,36,13,23,64,16,40,7,24,22,27,14,22,18,7,20,4,2,0
247,EwDDD2l5,GAL,2022,euro,60,40,8,21,69,16,29,5,40,13,17,10,30,14,6,12,5,0,0
248,EwDDD2l5,LIM,2022,euro,69,40,20,29,69,21,42,8,27,3,7,8,32,17,7,12,2,0,0
249,EwLzchyd,DUC,2022,bal,70,33,18,24,69,16,38,8,31,14,18,11,22,18,7,13,1,3,0
250,EwLzchyd,SLA,2022,bal,81,32,10,32,62,23,41,9,21,8,19,7,25,14,6,14,3,1,0
251,Ewenz5Yu,LUD,2021,euro,60,33,10,23,65,19,40,4,25,10,14,12,21,16,8,10,4,0,0
252,Ewenz5Yu,PRO,2021,euro,71,44,17,29,72,18,39,11,33,2,5,16,28,19,6,17,6,0,0
253,GAkp1RrC,REG,2023,bal,64,35,12,22,70,18,44,4,26,16,20,15,20,20,8,21,3,3,0
254,GAkp1RrC,STA,2023,bal,84,49,19,30,69,21,39,9,30,15,24,18,31,17,11,16,3,3,0
255,GCGrZzIB,PIN,2023,euro,97,25,25,39,70,30,46,9,24,10,15,5,20,21,3,7,2,0,0
256,GCGrZzIB,TEN,2023,euro,106,34,29,40,74,29,41,11,33,15,15,9,25,15,3,5,2,0,0
257,GGItA7VK,BES,2021,euro,75,29,16,26,61,21,37,5,24,18,21,6,23,18,9,17,3,0,0
258,GGItA7VK,SAN,2021,euro,82,32,17,28,66,15,35,13,31,13,13,10,22,22,6,16,2,0,0
259,GMskBYmK,IGO,2023,euro,65,23,19,21,63,12,31,9,32,14,17,6,17,16,7,11,3,0,0
260,GMskBYmK,TOF,2023,euro,99,40,25,35,60,19,32,16,28,13,17,7,33,18,10,13,7,0,0
261,GOxJBPLs,PER,2023,euro,90,40,17,32,65,23,42,9,23,17,25,12,28,22,2,6,2,0,0
262,GOxJBPLs,SZO,2023,euro,87,31,20,29,62,21,46,8,16,21,26,6,25,23,3,5,2,0,0
263,GQNDw32s,GAL,2021,euro,71,43,11,21,65,12,30,9,35,20,28,9,34,24,6,19,3,0,0
264,GQNDw32s,LUD,2021,euro,76,44,13,29,81,25,54,4,27,14,18,16,28,28,9,12,4,0,0
265,GSMC3ymR,DIJ,2021,euro,73,22,20,30,56,19,32,11,24,2,3,3,19,23,4,18,3,0,0
266,GSMC3ymR,LUD,2021,euro,95,35,13,32,63,21,43,11,20,20,26,11,24,15,11,10,1,0,0
267,GY91qkp6,CLU,2021,euro,67,27,17,20,47,16,29,4,18,23,31,7,20,23,4,17,3,0,0
268,GY91qkp6,LUD,2021,euro,92,36,16,33,75,23,47,10,28,16,22,12,24,28,10,9,1,0,0
269,GxnvxwYh,PER,2023,euro,62,38,15,19,50,8,24,11,26,13,18,11,27,18,2,11,0,0,0
270,GxnvxwYh,PIN,2023,euro,73,28,18,26,61,16,41,10,20,11,18,5,23,19,5,8,2,0,0
271,I3RUqiBT,BON,2022,euro,76,29,19,25,63,14,34,11,29,15,20,9,20,17,4,12,0,0,0
272,I3RUqiBT,STR,2022,euro,66,32,15,27,61,21,40,6,21,6,15,12,20,25,9,13,4,0,0
273,I73HTLRg,ASS,2022,bal,89,35,15,31,73,22,46,9,27,18,29,15,20,18,10,13,3,6,0
274,I73HTLRg,PET,2022,bal,102,42,23,35,67,16,31,19,36,13,22,11,31,24,11,16,6,3,0
275,I7mwqG4R,BRE,2023,euro,65,28,15,23,59,15,30,8,29,11,15,7,21,20,8,12,4,0,0
276,I7mwqG4R,BUR,2023,euro,77,32,16,27,57,20,40,7,17,16,24,8,24,22,5,11,3,0,0
277,IJTxvdXh,CLU,2021,euro,103,22,26,36,65,23,36,13,29,18,31,10,12,21,13,13,3,0,0
278,IJTxvdXh,DAR,2021,euro,101,28,18,35,56,27,38,8,18,23,28,8,20,29,6,21,3,0,0
279,INwJJFr9,SLA,2022,bal,55,34,7,20,58,17,42,3,16,12,18,12,22,14,5,18,2,0,0
280,INwJJFr9,USM,2022,bal,76,38,21,30,60,21,37,9,23,7,12,11,27,18,8,13,3,0,0
281,IRugpLM9,MUR,2022,euro,67,32,10,18,52,12,25,6,27,25,29,5,27,32,2,13,4,0,0
282,IRugpLM9,UNI,2022,euro,83,32,17,25,59,16,32,9,27,24,35,8,24,24,10,6,0,0,0
283,IcE99boB,STR,2023,euro,62,20,19,21,54,13,32,8,22,12,15,5,15,21,4,17,2,0,0
284,IcE99boB,UNI,2023,euro,91,38,16,32,59,22,36,10,23,17,21,9,29,21,13,12,1,0,0
285,Ict8cKQm,AEK,2022,euro,66,29,14,24,58,19,37,5,21,13,15,5,24,24,7,17,1,0,0
286,Ict8cKQm,UNI,2022,euro,88,35,22,32,65,24,45,8,20,16,26,7,28,18,8,9,5,0,0
287,IiFkv7Fb,HAP,2023,euro,61,26,11,21,58,17,39,4,19,15,23,7,19,18,8,8,3,0,0
288,IiFkv7Fb,MUR,2023,euro,78,37,13,30,63,21,36,9,27,9,10,10,27,21,7,14,2,0,0
289,Ikrwp5PD,BC,2021,euro,85,34,18,33,61,26,41,7,20,12,15,4,30,22,2,7,2,0,0
290,Ikrwp5PD,IGO,2021,euro,64,28,15,22,61,16,38,6,23,14,21,6,22,22,5,6,2,0,0
291,IoM5AB5e,FER,2022,bal,74,31,21,31,80,22,46,9,34,3,4,13,18,14,11,13,0,7,0
292,IoM5AB5e,SLA,2022,bal,78,34,21,27,51,16,30,11,21,13,18,8,26,8,7,18,7,0,0
293,IoUtVvd8,ASS,2021,bal,78,36,15,26,63,19,39,7,24,19,25,8,28,19,5,19,3,2,0
294,IoUtVvd8,PET,2021,bal,97,41,23,35,78,21,43,14,35,13,23,16,25,18,11,12,2,3,0
295,IoryQj5r,ESP,2022,bal,60,50,16,22,76,16,48,6,28,10,15,18,32,27,11,25,4,8,0
296,IoryQj5r,FAP,2022,bal,77,50,13,24,74,14,43,10,31,19,30,15,35,16,14,20,8,4,0
297,IqZKVfej,BEN,2023,euro,68,19,18,26,58,19,33,7,25,9,13,6,13,23,9,17,4,0,0
298,IqZKVfej,HAP,2023,euro,97,35,24,34,63,21,39,13,24,16,23,10,25,14,9,12,0,0,0
299,IqanjCPH,DAR,2022,euro,59,30,8,23,62,21,41,2,21,11,14,11,19,19,9,17,2,0,0
300,IqanjCPH,TEN,2022,euro,80,31,24,28,59,14,26,14,33,10,11,6,25,18,10,17,2,0,0
301,IsQZBfd7,PET,2022,bal,72,34,12,23,52,13,24,10,28,16,28,6,28,26,4,27,3,0,0
302,IsQZBfd7,USM,2022,bal,83,29,20,26,59,21,35,5,24,25,32,5,24,24,11,18,3,0,0
303,K0qtqSCN,DAR,2021,euro,80,29,17,30,63,23,38,7,25,13,16,10,19,19,10,9,1,0,0
304,K0qtqSCN,SAN,2021,euro,68,31,16,23,53,14,28,9,25,13,17,9,22,18,6,15,3,0,0
305,KAhVwa3t,HAP,2023,euro,83,27,21,31,56,23,32,8,24,13,19,9,18,19,8,9,1,0,0
306,KAhVwa3t,PIN,2023,euro,74,25,19,27,59,18,37,9,22,11,14,8,17,21,5,11,1,0,0
307,KAx0EMM6,HAP,2021,euro,90,38,19,32,62,25,35,7,19,19,23,7,31,22,11,23,4,0,0
308,KAx0EMM6,MAN,2021,euro,85,31,20,29,73,19,36,10,37,17,23,11,20,22,9,18,2,0,0
309,KC3OaucA,BON,2022,euro,99,41,17,37,71,24,37,13,34,12,15,11,30,27,7,11,7,0,0
310,KC3OaucA,RYT,2022,euro,72,21,14,22,54,12,25,10,29,18,21,2,19,22,4,14,3,0,0
311,KGD9ErZb,LIM,2022,euro,88,31,15,35,61,27,40,8,21,10,13,9,22,18,2,18,1,0,0
312,KGD9ErZb,UNI,2022,euro,99,24,30,33,66,20,32,13,34,20,22,8,16,17,10,6,2,0,0
313,KGZ4vzDr,BON,2023,euro,92,26,19,34,60,24,37,10,23,14,21,6,20,27,6,19,1,0,0
314,KGZ4vzDr,BRE,2023,euro,97,34,23,33,67,28,43,5,24,26,33,12,22,21,13,15,5,0,0
315,KICpUPCb,CAP,2023,bal,76,25,19,25,65,16,31,9,34,17,21,7,18,21,11,15,3,2,0
316,KICpUPCb,FER,2023,bal,82,48,15,30,74,27,60,3,14,19,22,21,27,18,8,25,2,3,0
317,KMl0t3m6,MAN,2022,euro,72,25,16,27,57,24,46,3,11,15,17,6,19,22,7,16,1,0,0
318,KMl0t3m6,TEN,2022,euro,84,30,17,28,54,17,29,11,25,17,22,6,24,24,9,16,1,0,0
319,KSyhxhxO,PER,2023,euro,83,39,18,28,58,19,38,9,20,18,27,10,29,24,4,9,4,0,0
320,KSyhxhxO,RYT,2023,euro,80,28,25,26,61,16,37,10,24,18,28,8,20,25,6,9,2,0,0
321,KbjLmULn,LIM,2022,euro,82,36,16,31,63,22,45,9,18,11,13,10,26,19,9,13,3,0,0
322,KbjLmULn,LUD,2022,euro,62,30,14,22,66,16,38,6,28,12,17,14,16,13,6,13,1,0,0
323,KdyAHnTh,ALA,2023,bal,92,32,24,30,59,21,32,9,27,23,26,4,28,25,6,15,5,0,0
324,KdyAHnTh,FER,2023,bal,74,42,10,25,74,23,61,2,13,22,30,19,23,19,5,10,0,5,0
325,Kf4MbpvA,DAR,2023,euro,83,46,16,33,74,27,49,6,25,11,16,15,31,13,4,13,7,0,0
326,Kf4MbpvA,LUD,2023,euro,72,28,19,27,72,17,41,10,31,8,11,9,19,19,4,8,5,0,0
327,Kl1P1qw1,RYT,2021,euro,84,33,18,32,73,25,49,7,24,13,17,14,19,21,10,11,1,0,0
328,Kl1P1qw1,SAN,2021,euro,77,29,16,30,61,23,38,7,23,10,14,8,21,21,6,15,5,0,0
329,KnnMc60J,BC,2021,euro,74,36,17,27,58,20,40,7,18,13,21,11,25,24,4,19,3,0,0
330,KnnMc60J,CLU,2021,euro,85,23,19,29,58,21,35,8,23,19,26,6,17,21,10,11,2,0,0
331,Krdy3mEa,ABI,2023,bal,90,35,15,33,79,23,50,10,29,14,17,10,25,24,11,10,2,2,0
332,Krdy3mEa,USM,2023,bal,74,33,9,26,57,17,25,9,32,13,19,5,28,19,4,22,2,2,0
333,KtDqUX57,MAN,2021,euro,87,28,12,30,68,21,35,9,33,18,24,12,16,20,5,9,3,0,0
334,KtDqUX57,TEN,2021,euro,98,27,26,40,61,27,37,13,24,5,9,2,25,21,3,10,0,0,0
335,KvSwyixs,HAP,2022,euro,103,41,33,36,69,20,35,16,34,15,19,14,27,24,6,8,0,0,0
336,KvSwyixs,IGO,2022,euro,79,27,15,24,53,13,23,11,30,20,25,5,22,21,3,9,0,0,0
337,M1kH1nfi,BRE,2023,euro,85,38,27,27,60,16,26,11,34,20,27,13,25,22,3,17,0,0,0
338,M1kH1nfi,PIN,2023,euro,89,28,20,31,63,20,35,11,28,16,24,7,21,24,10,11,0,0,0
339,M3OfX8y6,MUR,2022,euro,97,36,14,33,65,24,37,9,28,22,25,10,26,28,4,16,2,0,0
340,M3OfX8y6,PIN,2022,euro,92,29,8,29,65,20,39,9,26,25,35,9,20,25,6,9,2,0,0
341,M9auaeer,DIJ,2021,euro,78,26,15,33,72,25,42,8,30,4,4,6,20,20,16,10,3,0,0
342,M9auaeer,HAP,2021,euro,66,34,15,23,48,21,37,2,11,18,20,6,28,12,5,23,3,0,0
343,MBAcpVUa,CLU,2021,euro,76,33,21,27,56,17,31,11,25,9,12,4,29,16,4,18,3,0,0
344,MBAcpVUa,LUD,2021,euro,73,32,14,26,70,16,42,10,28,11,14,12,20,19,7,12,3,0,0
345,MBI6ISDn,DOU,2023,bal,76,42,18,26,63,18,43,8,20,16,25,13,29,22,9,19,1,5,0
346,MBI6ISDn,USM,2023,bal,60,28,12,19,59,13,28,6,31,16,23,9,19,22,10,21,5,1,0
347,MFd5VCsL,ASS,2022,bal,91,42,21,33,71,21,42,12,29,13,14,8,34,11,6,10,2,3,0
348,MFd5VCsL,DUC,2022,bal,86,30,23,35,76,28,48,7,28,9,10,5,25,16,10,7,3,2,0
349,MHNfHOxl,GAL,2021,euro,92,30,21,29,60,17,34,12,26,22,26,4,26,19,6,12,2,0,0
350,MHNfHOxl,NYM,2021,euro,86,35,19,27,74,15,38,12,36,20,22,13,22,23,7,11,1,0,0
351,ML3zPfDe,BRE,2023,euro,79,24,13,28,64,20,36,8,28,15,18,10,14,16,7,8,0,0,0
352,ML3zPfDe,HAP,2023,euro,84,26,15,31,57,17,34,14,23,8,12,7,19,20,3,15,1,0,0
353,MPcuXRSu,CIT,2023,bal,68,40,13,24,73,14,35,10,38,10,19,16,24,13,4,19,1,2,0
354,MPcuXRSu,SLA,2023,bal,96,40,28,40,77,32,56,8,21,8,18,11,29,16,12,9,2,1,0
355,MXDAQxZe,DAR,2021,euro,74,29,13,30,68,26,49,4,19,10,15,9,20,24,11,22,3,0,0
356,MXDAQxZe,MAN,2021,euro,89,39,26,29,60,20,35,9,25,22,30,12,27,21,15,22,5,0,0
357,ManxuVY3,TOF,2021,euro,92,36,24,37,55,28,40,9,15,9,13,3,33,18,11,12,3,0,0
358,ManxuVY3,TRE,2021,euro,51,20,16,17,56,11,26,6,30,11,16,5,15,14,6,16,0,0,0
359,MgJxBmGE,OLD,2021,euro,69,30,10,31,68,29,56,2,12,5,9,12,18,18,11,13,0,0,0
360,MgJxBmGE,RYT,2021,euro,71,36,16,25,57,20,35,5,22,16,21,12,24,18,12,17,7,0,0
361,MmUAnSTI,KWA,2023,bal,48,39,12,17,69,14,46,3,23,11,16,13,26,21,9,19,2,8,0
362,MmUAnSTI,REG,2023,bal,64,43,22,23,62,19,36,4,26,14,22,9,34,18,11,15,8,2,0
363,Mo3Ynkj1,RYT,2021,euro,91,27,14,31,67,18,37,13,30,16,20,9,18,18,8,10,2,0,0
364,Mo3Ynkj1,SZO,2021,euro,88,23,19,32,53,25,38,7,15,17,19,3,20,22,6,13,4,0,0
365,O0IXGYpi,BAN,2022,euro,92,26,21,31,53,20,32,11,21,19,22,6,20,18,9,17,3,0,0
366,O0IXGYpi,UNI,2022,euro,82,29,19,32,69,25,44,7,25,11,13,13,16,24,10,14,1,0,0
367,O8l80mvH,RYT,2021,euro,73,31,18,24,58,11,26,13,32,12,17,7,24,17,5,12,2,0,0
368,O8l80mvH,STR,2021,euro,71,36,19,29,62,21,43,8,19,5,11,9,27,16,7,11,1,0,0
369,OIkO3mH5,BNE,2022,euro,87,38,23,27,61,22,42,5,19,28,38,10,28,23,7,15,1,0,0
370,OIkO3mH5,PER,2022,euro,90,31,20,32,68,19,35,13,33,13,22,7,24,27,7,12,2,0,0
371,OKjSoFeK,HAP,2022,euro,87,23,18,32,59,23,38,9,21,14,24,10,13,17,12,13,1,0,0
372,OKjSoFeK,LUD,2022,euro,81,26,19,27,54,14,25,13,29,14,14,7,19,20,6,17,2,0,0
373,OMZGWztp,BEN,2023,euro,63,31,14,22,65,13,36,9,29,10,15,14,17,20,14,19,6,0,0
374,OMZGWztp,GAL,2023,euro,70,31,21,25,49,16,29,9,20,11,15,8,23,20,8,16,4,0,0
375,OQDo9aup,FAP,2022,bal,74,34,14,25,65,16,39,9,26,15,23,11,23,19,5,18,4,4,0
376,OQDo9aup,PET,2022,bal,88,38,24,33,71,23,37,10,34,12,15,9,29,22,10,17,4,4,0
377,OSf3mVeD,IGO,2023,euro,63,32,16,22,53,18,37,4,16,15,19,8,24,21,6,24,0,0,0
378,OSf3mVeD,MUR,2023,euro,79,31,18,30,62,22,37,8,25,11,17,7,24,22,19,16,3,0,0
379,OlK0G44n,AEK,2022,euro,82,26,27,31,55,24,36,7,19,13,23,6,20,20,11,14,0,0,0
380,OlK0G44n,LIM,2022,euro,72,26,18,24,49,11,26,13,23,11,18,6,20,22,3,17,1,0,0
381,OpA4ayk8,GAL,2023,euro,70,27,17,22,58,14,30,8,28,18,28,11,16,27,9,16,2,0,0
382,OpA4ayk8,HAP,2023,euro,85,36,19,30,58,23,39,7,19,18,30,13,23,28,10,14,2,0,0
383,Q92fljfU,DAR,2022,euro,87,27,19,31,68,22,43,9,25,16,19,8,19,26,11,11,1,0,0
384,Q92fljfU,MUR,2022,euro,96,33,21,30,58,15,28,15,30,21,26,7,26,23,4,18,4,0,0
385,QH05ENco,BC,2023,euro,72,29,16,30,63,27,49,3,14,9,17,6,23,21,6,12,3,0,0
386,QH05ENco,HAP,2023,euro,78,31,19,29,58,25,41,4,17,16,23,7,24,17,8,10,4,0,0
387,Qghz0qK5,DIJ,2022,euro,67,20,12,24,57,17,32,7,25,12,17,10,10,14,12,17,1,0,0
388,Qghz0qK5,STR,2022,euro,86,30,20,35,56,24,34,11,22,5,6,7,23,20,8,21,2,0,0
389,QiNlwYMH,PER,2023,euro,110,29,26,42,71,25,46,17,25,9,10,8,21,25,6,7,3,0,0
390,QiNlwYMH,RYT,2023,euro,92,30,23,28,61,16,33,12,28,24,31,11,19,17,4,13,1,0,0
391,Qm3dXYC8,ASS,2022,bal,91,35,14,29,64,16,33,13,31,20,30,9,26,19,9,13,0,7,0
392,Qm3dXYC8,SLA,2022,bal,79,43,12,29,73,23,49,6,24,15,25,17,26,21,7,15,5,0,0
393,QmsRHgDL,REG,2022,bal,83,35,16,31,74,21,45,10,29,11,12,11,24,22,9,13,4,5,0
394,QmsRHgDL,SLA,2022,bal,81,33,17,29,61,23,47,6,14,17,24,5,28,10,6,14,5,4,0
395,Qo6SkrF7,AEK,2023,euro,79,36,15,25,57,18,35,7,22,22,30,13,23,26,5,19,2,0,0
396,Qo6SkrF7,PRO,2023,euro,80,24,20,25,56,11,28,14,28,16,25,8,16,28,9,16,6,0,0
397,QqHlni0m,HAP,2021,euro,93,29,22,35,64,25,42,10,22,13,17,11,18,19,7,6,2,0,0
398,QqHlni0m,STR,2021,euro,75,33,14,26,58,23,45,3,13,20,23,13,20,16,4,11,2,0,0
399,QuXzOljP,REG,2023,bal,79,32,15,29,61,21,35,8,26,13,20,9,23,21,5,17,0,1,0
400,QuXzOljP,USM,2023,bal,84,27,19,27,58,16,26,11,32,19,22,5,22,21,8,13,1,0,0
401,Qw2keG0c,BON,2022,euro,83,26,12,27,59,21,32,6,27,23,30,8,18,23,7,11,1,0,0
402,Qw2keG0c,STR,2022,euro,77,28,15,26,63,17,37,9,26,16,19,12,16,25,3,14,2,0,0
403,QyVoZU6g,LIM,2022,euro,81,30,15,26,56,18,38,8,18,21,29,9,21,21,5,12,3,0,0
404,QyVoZU6g,LUD,2022,euro,85,27,21,29,64,17,36,12,28,15,19,7,20,22,8,9,1,0,0
405,SIfQoIK8,BON,2023,euro,82,30,13,31,58,21,33,10,25,10,16,7,23,24,2,13,0,0,0
406,SIfQoIK8,BUR,2023,euro,92,22,16,31,54,22,35,9,19,21,29,4,18,20,7,7,2,0,0
407,SK7UdO8M,GAL,2023,euro,71,31,17,19,55,12,29,7,26,26,34,10,21,23,5,16,2,0,0
408,SK7UdO8M,TOR,2023,euro,70,39,18,23,64,16,37,7,27,17,23,12,27,25,9,13,5,0,0
409,SSJv71zD,PER,2023,euro,76,35,18,26,59,21,41,5,18,19,24,4,31,25,7,17,1,0,0
410,SSJv71zD,UNI,2023,euro,73,37,15,24,68,21,49,3,19,22,28,11,26,19,9,14,1,0,0
411,SUttq6zI,PAO,2022,euro,81,32,15,30,62,16,32,14,30,7,13,9,23,23,6,9,3,0,0
412,SUttq6zI,RYT,2022,euro,78,34,16,28,61,21,35,7,26,15,18,10,24,20,4,11,1,0,0
413,SbAzIAlk,BAK,2022,euro,68,37,17,25,60,19,38,6,22,12,18,9,28,15,9,14,5,0,0
414,SbAzIAlk,DAR,2022,euro,66,38,16,27,68,21,43,6,25,6,11,10,28,18,8,14,1,0,0
415,Sf4gCwSl,HAP,2021,euro,69,38,24,24,62,13,29,11,33,10,17,6,32,16,7,15,9,0,0
416,Sf4gCwSl,LUD,2021,euro,51,43,10,19,71,14,41,5,30,8,14,16,27,19,7,14,4,0,0
417,SfOjI4Ns,BRI,2021,euro,80,30,22,33,70,22,40,11,30,3,7,6,24,26,3,8,2,0,0
418,SfOjI4Ns,HAP,2021,euro,84,34,18,27,64,16,34,11,30,19,23,11,23,16,6,6,0,0,0
419,SfxnlQ81,GAL,2021,euro,87,33,20,30,63,16,28,14,35,13,16,7,26,21,6,11,4,0,0
420,SfxnlQ81,PAO,2021,euro,75,27,22,25,59,15,35,10,24,15,20,7,20,18,5,14,2,0,0
421,ShqsqLBf,HAP,2022,euro,128,61,26,41,110,20,50,21,60,25,31,17,44,39,18,21,3,0,0
422,SlJ2J8bt,ABI,2023,bal,71,35,15,21,62,13,34,8,28,21,29,8,27,18,8,22,4,3,0
423,SlJ2J8bt,STA,2023,bal,90,45,28,36,78,28,56,8,22,10,17,13,32,23,15,16,3,4,0
424,SrGhS3sB,ALA,2023,bal,90,28,20,33,65,17,31,16,34,8,11,9,19,20,4,10,1,1,0
425,SrGhS3sB,PET,2023,bal,91,29,22,30,55,14,28,16,27,15,24,7,22,16,3,14,1,1,0
426,Sx7WcJRM,BAH,2022,euro,69,29,15,27,56,20,31,7,25,8,13,7,22,27,7,22,3,0,0
427,Sx7WcJRM,RYT,2022,euro,92,24,22,29,56,15,25,14,31,20,23,5,19,21,8,14,3,0,0
428,U9yQGhYC,BON,2022,euro,87,40,23,28,67,13,24,15,43,16,23,19,21,19,10,15,2,0,0
429,U9yQGhYC,MAN,2022,euro,69,32,13,27,65,20,42,7,23,8,15,12,20,20,4,21,0,0,0
430,UJCJi4pe,BON,2023,euro,85,31,21,31,69,20,38,11,31,12,15,9,22,22,9,14,2,0,0
431,UJCJi4pe,GAL,2023,euro,98,37,31,36,65,28,40,8,25,18,24,8,29,16,9,13,2,0,0
432,UJrGO6pE,DIJ,2021,euro,85,21,15,28,57,17,31,11,26,18,25,9,12,21,10,15,4,0,0
433,UJrGO6pE,NIZ,2021,euro,93,31,25,29,58,12,23,17,35,18,22,9,22,22,8,16,4,0,0
434,UPkpw93G,TOF,2021,euro,82,37,17,32,78,25,51,7,27,11,14,14,23,23,10,11,4,0,0
435,UPkpw93G,TRE,2021,euro,80,39,22,24,62,13,33,11,29,21,21,8,31,20,4,19,6,0,0
436,UTNP4WQm,MUR,2023,euro,90,32,29,36,68,24,42,12,26,6,8,11,21,23,5,13,2,0,0
437,UTNP4WQm,TOF,2023,euro,75,24,18,26,52,22,34,4,18,19,25,3,21,13,6,12,1,0,0
438,UZ2mcZPf,DIJ,2021,euro,72,33,17,26,60,15,28,11,32,9,12,7,26,20,9,16,6,0,0
439,UZ2mcZPf,LUD,2021,euro,84,38,14,29,68,19,45,10,23,16,22,13,25,16,9,12,4,0,0
440,UaUtGYmB,TEN,2022,euro,84,27,24,29,55,15,27,14,28,12,14,1,26,24,6,16,5,0,0
441,UaUtGYmB,UNI,2022,euro,79,33,11,28,66,21,41,7,25,16,19,13,20,21,10,14,3,0,0
442,UkaVpHIH,LUD,2023,euro,60,31,14,20,72,10,34,10,38,10,16,9,22,18,7,9,3,0,0
443,UkaVpHIH,SZC,2023,euro,80,43,15,29,58,23,39,6,19,16,23,5,38,20,4,17,4,0,0
444,W0IVCOsO,FER,2023,bal,109,34,20,37,70,26,50,11,20,24,33,12,22,23,8,14,3,6,0
445,W0IVCOsO,SLA,2023,bal,97,30,14,35,74,26,45,9,29,18,21,12,18,25,7,14,6,3,0
446,W0pCdvtf,AEK,2022,euro,81,44,19,31,70,19,39,12,31,7,10,15,29,17,6,12,3,0,0
447,W0pCdvtf,GAL,2022,euro,71,32,14,25,68,15,32,10,36,11,14,8,24,17,7,7,2,0,0
448,WAsonshc,MAN,2022,euro,84,26,22,30,68,21,44,9,24,15,15,5,21,25,11,8,2,0,0
449,WAsonshc,TEN,2022,euro,91,35,18,30,59,18,29,12,30,19,24,7,28,17,4,17,1,0,0
450,WEVszBim,BAH,2022,euro,72,23,19,27,58,18,35,9,23,9,14,5,18,16,13,9,2,0,0
451,WEVszBim,BC,2022,euro,76,40,21,29,63,18,34,11,29,7,9,15,25,17,7,18,2,0,0
452,WKQJFadL,PET,2021,bal,64,31,18,22,60,18,46,4,14,16,25,10,21,27,7,25,4,4,0
453,WKQJFadL,ZAM,2021,bal,97,40,23,37,71,31,49,6,22,17,28,15,25,27,13,18,4,4,0
454,WMTE6dVT,HAP,2023,euro,85,29,20,27,53,16,31,11,22,20,25,7,22,18,2,11,3,0,0
455,WMTE6dVT,TEN,2023,euro,61,25,8,24,62,20,34,4,28,9,11,8,17,25,4,12,2,0,0
456,WMy9RTVh,DIJ,2023,euro,59,19,8,23,61,20,44,3,17,10,12,5,14,20,18,17,1,0,0
457,WMy9RTVh,LUD,2023,euro,71,39,13,24,55,18,33,6,22,17,18,12,27,17,7,27,5,0,0
458,WYmCa7gN,STR,2021,euro,98,39,18,35,78,20,47,15,31,13,15,16,23,22,6,9,4,0,0
459,WYmCa7gN,SZO,2021,euro,86,37,16,29,63,25,52,4,11,24,28,9,28,21,6,13,5,0,0
460,WhnsqPvK,PAO,2021,euro,78,22,18,28,53,13,25,15,28,7,7,5,17,26,3,17,1,0,0
461,WhnsqPvK,STR,2021,euro,105,26,25,33,62,20,36,13,26,26,31,9,17,14,5,5,2,0,0
462,WlnuPAKl,CAP,2022,bal,18,18,4,13,0,10,6,1,10,4,9,3,15,6,5,7,3,0,0
463,WlnuPAKl,PET,2022,bal,15,4,3,14,5,8,13,5,0,4,7,9,10,0,1,5,2,0,0
464,WnaaaBoU,MAN,2022,euro,82,41,23,31,74,22,44,9,30,11,12,9,32,21,7,6,3,0,0
465,WnaaaBoU,RYT,2022,euro,69,43,12,22,70,10,36,12,34,13,15,13,30,18,2,16,4,0,0
466,Wr966eJ7,ASP,2021,bal,65,41,19,25,76,22,55,3,21,12,17,18,23,19,8,22,2,3,0
467,Wr966eJ7,FAP,2021,bal,87,46,25,34,84,24,52,10,32,9,16,19,27,21,14,14,3,2,0
468,WrkS27WB,RYT,2022,euro,85,40,18,33,69,22,38,11,31,8,12,17,23,24,5,14,4,0,0
469,WrkS27WB,TEN,2022,euro,78,26,20,26,60,14,34,12,26,14,19,9,17,20,6,11,1,0,0
470,WzL9KK4C,OPA,2023,euro,75,33,15,29,75,22,46,7,29,10,14,17,16,28,14,18,0,0,0
471,WzL9KK4C,RYT,2023,euro,95,57,23,33,79,22,39,11,40,18,30,29,28,20,11,22,4,0,0
472,Wzc3WxLL,BC,2023,euro,78,25,17,30,56,23,34,7,22,11,14,3,22,22,3,10,1,0,0
473,Wzc3WxLL,PIN,2023,euro,76,29,20,25,55,15,33,10,22,16,24,6,23,17,1,10,0,0,0
474,YDnr9aE0,ASS,2021,bal,72,28,13,25,64,19,40,6,24,16,19,6,22,17,11,19,1,1,0
475,YDnr9aE0,PET,2021,bal,79,37,16,30,61,22,40,8,21,11,18,9,28,21,10,24,1,1,0
476,YF7SbaCG,BAH,2022,euro,72,33,12,25,68,15,35,10,33,12,17,11,22,21,7,17,0,0,0
477,YF7SbaCG,MAN,2022,euro,90,38,25,35,65,26,35,9,30,11,14,6,32,21,7,14,2,0,0
478,YHYK3YSm,PET,2021,bal,71,30,11,28,73,21,46,7,27,8,10,8,22,23,8,17,2,3,0
479,YHYK3YSm,ZAM,2021,bal,89,40,25,36,65,29,46,7,19,10,18,9,31,13,9,19,3,2,0
480,YJiva3ZB,DIJ,2022,euro,64,27,18,26,58,22,40,4,18,8,9,8,19,19,11,14,0,0,0
481,YJiva3ZB,HAP,2022,euro,73,27,21,26,53,17,31,9,22,12,23,6,21,17,8,16,4,0,0
482,YN5Mnwl5,BAN,2023,euro,80,27,16,25,59,18,37,7,22,23,27,7,20,16,4,15,3,0,0
483,YN5Mnwl5,LUD,2023,euro,97,39,22,36,73,22,39,14,34,11,14,17,22,23,10,9,5,0,0
484,YRcT49qm,KWA,2023,bal,75,30,19,26,65,17,38,9,27,14,22,10,20,21,5,12,3,3,0
485,YRcT49qm,USM,2023,bal,85,38,32,30,65,19,35,11,30,14,22,12,26,17,5,13,3,3,0
486,YVFt2Gwo,HAP,2023,euro,92,26,19,37,66,27,43,10,23,8,11,10,16,25,7,14,1,0,0
487,YVFt2Gwo,TEN,2023,euro,95,23,17,32,56,21,35,11,21,20,23,6,17,20,9,11,2,0,0
488,YVqA08G0,BC,2021,euro,59,30,10,21,51,15,37,6,14,11,17,8,22,20,4,22,3,0,0
489,YVqA08G0,UNI,2021,euro,75,28,20,29,66,20,40,9,26,8,13,8,20,20,10,13,4,0,0
490,YcxfAh3Q,MUR,2023,euro,87,30,15,32,69,22,41,10,28,13,15,9,21,24,14,11,3,0,0
491,YcxfAh3Q,TOR,2023,euro,75,27,11,22,55,13,32,9,23,22,28,10,17,19,6,20,7,0,0
492,YeNkXDIg,BIL,2022,euro,66,33,12,24,62,18,40,6,22,12,17,14,19,18,8,12,4,0,0
493,YeNkXDIg,TEN,2022,euro,78,26,17,29,56,20,34,9,22,11,13,5,21,16,5,12,1,0,0
494,Yg8FKb9D,HAP,2023,euro,77,38,14,23,57,16,37,7,20,24,36,8,30,22,7,18,4,0,0
495,Yg8FKb9D,PER,2023,euro,71,28,16,27,62,18,35,9,27,8,15,8,20,27,3,10,1,0,0
496,YodYXVhP,DIJ,2023,euro,82,17,16,31,64,21,36,10,28,10,14,5,12,22,12,9,3,0,0
497,YodYXVhP,LUD,2023,euro,89,33,17,29,48,18,24,11,24,20,24,5,28,18,5,19,1,0,0
498,bJvwp1dl,HAP,2022,euro,110,42,19,35,71,23,38,12,33,28,32,9,33,18,7,15,3,0,0
499,bJvwp1dl,STR,2022,euro,112,38,22,43,89,32,56,11,33,15,16,12,26,25,10,10,1,0,0
500,bVAb8Hle,PAT,2021,bal,75,33,17,26,60,18,38,8,22,15,19,7,26,27,4,17,1,3,0
501,bVAb8Hle,USM,2021,bal,91,33,20,31,67,22,39,9,28,20,28,11,22,20,10,10,3,1,0
502,bVY6I1C2,GNB,2021,bal,56,16,4,21,49,15,29,6,20,8,10,7,9,12,6,11,1,0,0
503,bVY6I1C2,USM,2021,bal,113,44,35,46,71,38,50,8,21,13,18,11,33,15,13,20,5,0,0
504,bZIMpdjr,CHO,2023,euro,97,35,25,34,72,20,43,14,29,15,21,11,24,19,3,1,2,0,0
505,bZIMpdjr,DAR,2023,euro,86,38,12,31,65,18,32,13,33,11,15,12,26,21,1,8,2,0,0
506,bcFF11Sc,BAH,2022,euro,76,34,19,27,64,14,33,13,31,9,9,9,25,21,1,11,3,0,0
507,bcFF11Sc,MAN,2022,euro,77,29,15,24,57,14,35,10,22,19,21,9,20,16,8,9,2,0,0
508,bkkPnlyg,AEK,2022,euro,85,30,21,30,60,21,41,9,19,16,22,9,21,24,6,13,4,0,0
509,bkkPnlyg,TOF,2022,euro,82,28,19,31,62,22,41,9,21,11,19,8,20,24,5,13,2,0,0
510,bmSNAqyl,MAN,2023,euro,85,34,19,30,59,26,39,4,20,21,29,11,23,19,6,8,4,0,0
511,bmSNAqyl,UNI,2023,euro,78,33,23,28,65,19,35,9,30,13,19,11,22,21,5,9,3,0,0
512,bsuWB1Us,DOU,2021,bal,62,30,12,25,64,18,45,7,19,5,6,5,25,22,8,16,1,6,0
513,bsuWB1Us,USM,2021,bal,86,36,28,28,57,18,28,10,29,20,28,5,31,15,7,17,6,1,0
514,buhkL0LT,BES,2021,euro,68,31,16,23,60,16,36,7,24,15,19,9,22,18,4,4,0,0,0
515,buhkL0LT,HAP,2021,euro,74,28,17,25,55,17,31,8,24,16,18,6,22,22,2,10,0,0,0
516,byCTQDJf,BAH,2022,euro,77,29,13,26,63,14,34,12,29,13,16,8,21,17,5,9,6,0,0
517,byCTQDJf,IGO,2022,euro,72,35,16,26,61,21,45,5,16,15,18,11,24,19,5,11,1,0,0
518,dCD4MyNt,HAP,2021,euro,95,39,13,32,63,16,31,16,32,15,17,6,33,20,8,13,6,0,0
519,dCD4MyNt,PRO,2021,euro,70,29,15,23,66,13,35,10,31,14,17,10,19,20,4,10,3,0,0
520,dGTBvdQJ,HAP,2022,euro,71,36,16,26,62,16,37,10,25,9,17,10,26,18,3,10,6,0,0
521,dGTBvdQJ,STR,2022,euro,63,38,15,24,68,22,43,2,25,13,17,10,28,19,8,7,4,0,0
522,dUAwhYf5,BIL,2022,euro,85,36,21,24,46,14,22,10,24,27,31,5,31,14,5,19,7,0,0
523,dUAwhYf5,DAR,2022,euro,75,22,16,30,70,20,44,10,26,5,6,9,13,25,12,9,1,0,0
524,dUW87Dfh,DAR,2022,euro,71,33,9,28,61,21,46,7,15,8,10,8,25,25,10,16,2,0,0
525,dUW87Dfh,TEN,2022,euro,75,26,18,24,57,19,34,5,23,22,25,4,22,17,7,14,3,0,0
526,dYOwBEBD,FAP,2022,bal,74,32,19,23,72,18,47,5,25,23,36,15,17,19,5,13,5,0,0
527,dYOwBEBD,ZAM,2022,bal,97,46,27,33,67,19,35,14,32,17,24,9,37,28,5,17,4,0,0
528,db2LSus0,CAP,2022,bal,67,25,16,26,74,16,44,10,30,5,7,6,19,16,5,11,3,3,0
529,db2LSus0,USM,2022,bal,106,47,32,40,71,26,36,14,35,12,16,8,39,12,6,13,3,3,0
530,db47d8si,MAN,2021,euro,85,50,22,28,70,24,41,4,29,25,31,21,29,19,9,7,4,0,0
531,db47d8si,TOF,2021,euro,70,29,9,25,58,17,33,8,25,12,17,6,23,23,3,14,5,0,0
532,db8CcFJK,GAL,2023,euro,85,35,27,26,58,12,24,14,34,19,25,11,24,21,10,12,0,0,0
533,db8CcFJK,PAO,2023,euro,79,26,19,25,52,11,26,14,26,15,24,5,21,26,8,11,1,0,0
534,dd3tTvwK,PET,2022,bal,72,34,12,24,73,18,40,6,33,18,25,14,20,19,4,10,2,4,0
535,dd3tTvwK,ZAM,2022,bal,85,36,21,32,61,24,41,8,20,13,20,6,30,23,6,11,4,2,0
536,ddemSDVm,BON,2022,euro,69,31,9,21,54,13,31,8,23,19,26,7,24,23,7,15,3,0,0
537,ddemSDVm,UNI,2022,euro,67,39,15,24,70,17,36,7,34,12,15,12,27,22,8,14,3,0,0
538,djShwGI1,STR,2021,euro,71,32,18,23,49,17,38,6,11,14,22,12,24,28,13,17,7,0,0
539,djShwGI1,TEN,2021,euro,69,32,24,24,55,18,32,6,23,15,19,11,26,19,11,17,5,0,0
540,dxTpUbBE,GNB,2021,bal,72,34,17,27,68,19,39,8,29,10,16,8,26,19,8,18,2,5,0
541,dxTpUbBE,PAT,2021,bal,78,49,20,32,76,25,52,7,24,7,20,19,30,19,9,19,5,2,0
542,f3RxRHEP,PIN,2021,euro,88,30,19,31,58,20,36,11,22,15,21,10,20,20,5,10,4,0,0
543,f3RxRHEP,TEN,2021,euro,80,27,22,26,60,14,25,12,35,16,20,10,17,20,8,8,2,0,0
544,f7Hp9RpR,AEK,2021,euro,83,38,16,26,69,20,42,6,27,25,35,13,25,18,6,8,3,0,0
545,f7Hp9RpR,SZO,2021,euro,89,41,24,37,70,28,47,9,23,6,12,7,34,23,6,14,2,0,0
546,fHM2Vn6I,BEN,2022,euro,76,31,16,28,63,22,37,6,26,14,20,13,18,18,6,19,2,0,0
547,fHM2Vn6I,DAR,2022,euro,89,25,26,31,60,22,34,9,26,18,19,3,22,24,13,15,3,0,0
548,fHrYpS55,MUR,2022,euro,96,36,23,30,57,19,30,11,27,25,29,8,28,20,2,15,1,0,0
549,fHrYpS55,PIN,2022,euro,89,27,21,35,76,26,51,9,25,10,15,10,17,26,7,6,1,0,0
550,fNwL9Ekg,CHO,2023,euro,98,25,22,34,65,21,34,13,31,17,19,10,15,19,8,10,1,0,0
551,fNwL9Ekg,STR,2023,euro,93,33,24,37,66,27,43,10,23,9,11,13,20,19,5,12,1,0,0
552,fZumcs4O,GAL,2022,euro,100,36,24,35,66,25,42,10,24,20,22,14,22,15,8,12,1,0,0
553,fZumcs4O,LIM,2022,euro,73,14,16,30,62,22,36,8,26,5,6,7,7,19,7,13,3,0,0
554,fecVwq2p,PAO,2023,euro,63,20,11,22,61,16,35,6,26,13,17,5,15,21,9,7,1,0,0
555,fecVwq2p,TOF,2023,euro,95,41,22,33,66,19,34,14,32,15,16,12,29,19,4,12,2,0,0
556,fyaP5kUt,ABI,2023,bal,70,29,18,23,60,13,31,10,29,14,17,7,22,14,4,14,2,5,0
557,fyaP5kUt,REG,2023,bal,74,33,22,27,61,18,37,9,24,11,13,9,24,15,5,15,4,0,0
558,h4vzBLql,FER,2021,bal,71,40,21,24,73,18,44,6,29,17,20,17,23,23,9,22,3,3,0
559,h4vzBLql,PAT,2021,bal,73,36,18,24,63,11,33,13,30,12,25,11,25,22,9,22,3,3,0
560,h4zlNlk1,CAP,2022,bal,77,31,9,25,67,19,39,6,28,21,25,4,27,21,4,10,4,5,0
561,h4zlNlk1,ZAM,2022,bal,101,44,22,37,77,25,40,12,37,15,24,13,31,22,3,10,5,4,0
562,hGYKfIA6,AEK,2022,euro,65,28,16,24,56,21,37,3,19,14,17,5,23,19,5,12,1,0,0
563,hGYKfIA6,UNI,2022,euro,75,32,19,28,64,20,39,8,25,11,14,13,19,23,4,11,5,0,0
564,hKdgrFwi,DOU,2023,bal,93,46,21,35,78,24,50,11,28,12,23,19,27,24,12,18,0,1,0
565,hKdgrFwi,FER,2023,bal,73,44,11,24,72,17,43,7,29,18,33,21,23,21,12,20,1,0,0
566,hKrsmNxi,AEK,2022,euro,94,26,21,33,60,20,32,13,28,15,19,7,19,28,8,14,0,0,0
567,hKrsmNxi,HAP,2022,euro,78,26,16,26,53,17,32,9,21,17,29,8,18,24,6,17,4,0,0
568,hQeUQJBC,FAP,2022,bal,66,46,13,21,61,17,48,4,13,20,39,12,34,28,15,21,1,3,0
569,hQeUQJBC,REG,2022,bal,63,43,15,15,61,7,25,8,36,25,33,8,35,30,10,24,3,1,0
570,hSlCNI0s,ESP,2022,bal,90,42,23,32,78,20,45,12,33,14,21,18,24,25,5,14,2,2,0
571,hSlCNI0s,ZAM,2022,bal,83,36,23,29,61,20,36,9,25,16,25,10,26,17,4,8,2,2,0
572,hUJvdCj2,ASS,2022,bal,87,36,19,29,68,21,37,8,31,21,29,11,25,16,7,13,1,3,0
573,hUJvdCj2,REG,2022,bal,91,39,29,35,77,24,44,11,33,10,17,13,26,22,10,13,3,1,0
574,hURFGusF,ASS,2021,bal,87,38,13,28,54,21,33,7,21,24,34,6,32,24,6,22,6,1,0
575,hURFGusF,FAP,2021,bal,84,40,16,28,82,15,46,13,36,15,26,16,24,26,3,15,1,6,0
576,hWx5S9Gn,GAL,2023,euro,80,28,23,30,71,24,48,6,23,14,19,7,21,18,5,6,5,0,0
577,hWx5S9Gn,LUD,2023,euro,100,41,19,33,72,18,37,15,35,19,19,11,30,18,2,10,5,0,0
578,hb96RIJk,DAR,2021,euro,88,37,18,33,67,25,44,8,23,14,18,14,23,16,10,12,3,0,0
579,hb96RIJk,TRE,2021,euro,76,26,19,27,65,12,29,15,36,7,9,9,17,18,7,16,1,0,0
580,hdQH5iP4,BIL,2022,euro,67,33,10,22,57,14,34,8,23,15,20,8,25,23,6,13,4,0,0
581,hdQH5iP4,MUR,2022,euro,71,33,14,25,64,18,41,7,23,14,19,12,21,23,7,10,2,0,0
582,hfeWpZAQ,DAR,2022,euro,69,31,13,22,63,14,35,8,28,17,23,12,19,19,6,15,4,0,0
583,hfeWpZAQ,HAP,2022,euro,92,32,27,32,60,21,34,11,26,17,22,6,26,23,8,14,3,0,0
584,hhA27y41,GNB,2021,bal,69,25,15,30,69,21,46,9,22,0,0,2,23,13,4,14,1,0,0
585,hhA27y41,RIV,2021,bal,75,38,14,29,68,23,45,6,23,11,16,14,24,6,11,12,3,0,0
586,hlEf2kDo,PIN,2021,euro,71,34,9,22,61,13,37,9,24,18,20,12,22,22,3,11,0,0,0
587,hlEf2kDo,TEN,2021,euro,74,28,18,26,60,13,27,13,33,9,16,7,21,23,4,8,3,0,0
588,hpM5L0k6,DIJ,2023,euro,99,33,25,36,70,26,35,10,35,17,22,10,23,20,13,13,4,0,0
589,hpM5L0k6,OPA,2023,euro,64,36,16,22,62,14,31,8,31,12,17,15,21,21,8,25,2,0,0
590,ht8WQS2n,PIN,2023,euro,87,33,19,31,66,18,35,13,31,12,14,9,24,20,5,11,7,0,0
591,ht8WQS2n,STR,2023,euro,72,25,22,27,57,21,39,6,18,12,20,4,21,18,7,10,2,0,0
592,hxU3Lobp,DIJ,2021,euro,84,36,17,33,67,22,39,11,28,7,11,13,23,17,6,8,2,0,0
593,hxU3Lobp,RIG,2021,euro,77,29,16,27,55,13,22,14,33,9,17,9,20,17,4,13,3,0,0
594,j55ByVXC,MAN,2022,euro,82,27,21,29,59,19,33,10,26,14,16,9,18,19,7,13,1,0,0
595,j55ByVXC,RIG,2022,euro,80,32,19,29,59,19,31,10,28,12,18,10,22,15,5,13,0,0,0
596,j9VxHEY4,BON,2022,euro,77,29,12,26,63,18,37,8,26,17,22,11,18,23,5,5,3,0,0
597,j9VxHEY4,HAP,2022,euro,70,34,10,23,55,15,32,8,23,16,26,13,21,20,3,13,2,0,0
598,j9gn0tkl,AEK,2021,euro,69,23,20,27,58,20,32,7,26,8,14,6,17,15,8,12,1,0,0
599,j9gn0tkl,TRE,2021,euro,81,37,19,29,60,13,26,16,34,7,8,11,26,17,4,15,3,0,0
600,jJ2pSbhQ,FAP,2022,bal,60,44,10,25,73,21,50,4,23,6,8,19,25,17,9,19,4,4,0
601,jJ2pSbhQ,PET,2022,bal,73,41,16,25,66,15,32,10,34,13,15,14,27,12,8,15,4,4,0
602,jLPxtyYu,BAH,2022,euro,87,42,21,30,70,19,39,11,31,16,25,11,31,17,7,10,7,0,0
603,jLPxtyYu,BC,2022,euro,81,30,16,27,65,11,31,16,34,11,17,3,27,27,4,10,5,0,0
604,jNn7K5Dj,DIJ,2021,euro,83,32,21,31,63,23,39,8,24,13,22,12,20,16,11,11,1,0,0
605,jNn7K5Dj,RIG,2021,euro,79,25,25,29,54,22,30,7,24,14,20,4,21,18,3,16,0,0,0
606,jTDFhpVl,DIJ,2023,euro,96,23,23,33,64,23,37,10,27,20,25,10,13,20,8,12,1,0,0
607,jTDFhpVl,GAL,2023,euro,93,26,24,31,52,19,29,12,23,19,22,5,21,23,9,17,1,0,0
608,jXFB2sDi,BAH,2022,euro,88,25,17,30,62,22,36,8,26,20,26,5,20,19,3,8,1,0,0
609,jXFB2sDi,RYT,2022,euro,95,33,20,33,63,21,34,12,29,17,22,9,24,24,6,12,1,0,0
610,jXT09ZPu,BIL,2022,euro,85,21,23,29,61,20,35,9,26,18,20,8,13,23,11,11,3,0,0
611,jXT09ZPu,DAR,2022,euro,93,39,18,31,64,23,43,8,21,23,25,14,25,24,6,15,3,0,0
612,jZWOMpFQ,BC,2021,euro,92,31,20,31,56,21,36,10,20,20,27,6,25,26,8,19,3,0,0
613,jZWOMpFQ,STR,2021,euro,91,31,15,31,68,23,44,8,24,21,34,13,18,22,13,10,2,0,0
614,jaSlTIQK,DOU,2021,bal,74,39,18,29,76,19,44,10,32,6,14,15,24,23,10,14,2,4,0
615,jaSlTIQK,FER,2021,bal,88,40,22,27,67,14,35,13,32,21,23,11,29,12,5,17,4,2,0
616,jkXT7hK5,CHO,2023,euro,71,37,15,25,71,17,37,8,34,13,14,19,18,18,9,14,1,0,0
617,jkXT7hK5,TOF,2023,euro,84,33,23,29,61,14,30,15,31,11,17,12,21,18,7,15,3,0,0
618,jkcwAuaf,FAP,2021,bal,53,42,10,19,67,17,46,2,21,13,20,11,31,20,5,14,4,4,0
619,jkcwAuaf,ZAM,2021,bal,82,39,28,31,71,21,41,10,30,10,21,14,25,16,6,12,4,4,0
620,josNBlup,PRO,2021,euro,70,37,16,23,64,14,37,9,27,15,21,8,29,15,6,9,2,0,0
621,josNBlup,UNI,2021,euro,69,38,12,27,69,19,40,8,29,7,8,8,30,20,5,14,4,0,0
622,jy0N2ozm,DIJ,2022,euro,84,31,28,35,64,29,43,6,21,8,11,8,23,21,5,9,2,0,0
623,jy0N2ozm,HAP,2022,euro,77,28,23,27,56,20,37,7,19,16,23,7,21,17,7,11,2,0,0
624,l0iGev5k,PAT,2021,bal,83,38,19,28,66,17,40,11,26,16,20,10,28,12,7,13,4,5,0
625,l0iGev5k,RIV,2021,bal,60,38,17,23,73,17,39,6,34,8,9,15,23,21,7,18,5,4,0
626,l81uP6Xb,OLD,2023,euro,77,31,14,28,64,19,40,9,24,12,14,6,25,24,6,10,0,0,0
627,l81uP6Xb,STR,2023,euro,85,30,23,31,58,21,36,10,22,13,22,6,24,16,6,10,3,0,0
628,l8Xksat7,HAP,2022,euro,65,37,15,24,60,18,37,6,23,11,19,12,25,14,6,15,4,0,0
629,l8Xksat7,STR,2022,euro,80,29,18,31,65,18,38,13,27,5,5,8,21,20,6,14,0,0,0
630,l8svNr5b,PAT,2021,bal,46,36,10,16,57,7,28,9,29,5,9,10,26,16,2,24,2,2,0
631,l8svNr5b,USM,2021,bal,87,36,23,34,68,24,45,10,23,9,12,8,28,16,18,8,2,2,0
632,lC7bXI5F,OLD,2023,euro,94,37,19,36,67,28,40,8,27,14,16,16,21,17,5,10,0,0,0
633,lC7bXI5F,PIN,2023,euro,88,15,24,31,57,19,27,12,30,14,15,4,11,18,4,11,0,0,0
634,lOmha5DO,ABI,2023,bal,79,34,16,27,70,18,40,9,30,16,21,7,27,24,12,10,4,5,0
635,lOmha5DO,KWA,2023,bal,76,48,17,25,63,18,34,7,29,19,28,14,34,16,5,21,5,4,0
636,lUrkyHXS,BEN,2023,euro,74,31,18,25,67,13,33,12,34,12,18,14,17,26,9,8,3,0,0
637,lUrkyHXS,PAO,2023,euro,76,30,17,26,52,19,34,7,18,17,24,6,24,20,4,13,1,0,0
638,lYrZqdkL,BON,2023,euro,72,39,18,25,71,15,36,10,35,12,18,12,27,20,10,7,1,0,0
639,lYrZqdkL,HAP,2023,euro,65,38,11,23,65,18,37,5,28,14,17,9,29,18,5,13,3,0,0
640,lb41QsCN,ALA,2023,bal,80,39,21,29,64,24,39,5,25,17,23,13,26,19,7,21,3,1,0
641,lb41QsCN,SLA,2023,bal,70,27,11,23,59,21,46,2,13,22,25,7,20,19,11,17,1,3,0
642,lfMdAVLP,KWA,2023,bal,74,40,16,23,63,14,43,9,20,19,30,17,23,22,8,21,1,7,0
643,lfMdAVLP,STA,2023,bal,78,42,19,31,72,28,53,3,19,13,22,19,23,24,10,18,7,1,0
644,lfrLLdVg,COB,2022,bal,64,39,10,22,64,16,41,6,23,14,28,12,27,23,7,18,8,0,0
645,lfrLLdVg,FAP,2022,bal,71,42,12,26,76,22,52,4,24,15,31,20,22,23,13,11,9,0,0
646,llX3G3Ci,BEN,2022,euro,59,25,18,21,66,16,40,5,26,12,15,8,17,17,11,11,3,0,0
647,llX3G3Ci,LIM,2022,euro,79,37,19,29,54,24,41,5,13,16,20,7,30,20,5,15,1,0,0
648,lnI0vVYj,AEK,2022,euro,55,31,17,19,49,12,26,7,23,10,15,3,28,16,6,17,2,0,0
649,lnI0vVYj,HAP,2022,euro,64,37,13,23,61,14,33,9,28,9,14,9,28,20,12,11,5,0,0
650,lvrxpnLB,BEN,2022,euro,72,34,17,24,65,15,31,9,34,15,20,12,22,23,13,20,3,0,0
651,lvrxpnLB,DAR,2022,euro,83,39,19,30,65,23,39,7,26,16,22,12,27,22,12,24,1,0,0
652,lxTQD4SH,ALA,2023,bal,72,40,16,25,71,16,35,9,36,13,13,11,29,20,10,18,6,1,0
653,lxTQD4SH,CIT,2023,bal,70,38,13,26,66,19,42,7,24,11,21,10,28,12,8,16,1,6,0
654,lxeeGUWS,CLU,2021,euro,92,34,16,36,67,24,42,12,25,8,14,6,28,24,8,14,0,0,0
655,lxeeGUWS,PRO,2021,euro,81,36,16,27,70,19,43,8,27,19,25,9,27,16,8,14,4,0,0
656,n1OpvE7B,MAN,2023,euro,78,35,13,28,64,18,41,10,23,12,24,16,19,22,8,16,1,0,0
657,n1OpvE7B,PRO,2023,euro,91,25,16,32,56,15,28,17,28,10,17,6,19,29,10,15,5,0,0
658,n3gW0P4a,DIJ,2022,euro,89,29,17,31,68,20,39,11,29,16,18,12,17,20,10,9,3,0,0
659,n3gW0P4a,HAP,2022,euro,81,27,20,28,47,19,28,9,19,16,20,3,24,17,5,18,3,0,0
660,nHh9ovBL,STR,2021,euro,67,28,13,28,63,23,46,5,17,6,13,11,17,18,6,12,5,0,0
661,nHh9ovBL,TEN,2021,euro,85,28,13,31,57,20,31,11,26,12,16,9,19,13,7,11,3,0,0
662,nJ3jkWvO,DAR,2022,euro,105,37,19,33,74,26,49,7,25,32,38,12,25,28,9,22,3,0,0
663,nJ3jkWvO,MUR,2022,euro,104,43,21,34,84,21,56,13,28,23,33,18,25,31,8,17,2,0,0
664,nJRXLPaU,HAP,2023,euro,65,25,17,20,59,10,28,10,31,15,19,4,21,17,10,10,3,0,0
665,nJRXLPaU,PRO,2023,euro,74,43,12,27,63,18,36,9,27,11,14,13,30,20,4,13,4,0,0
666,nNm3hckp,MAN,2022,euro,95,35,18,32,76,21,47,11,29,20,25,13,22,24,7,12,1,0,0
667,nNm3hckp,RYT,2022,euro,96,35,18,33,67,20,34,13,33,17,23,9,26,25,7,15,4,0,0
668,nTQLzhC7,HAP,2023,euro,77,28,21,28,62,22,45,6,17,15,21,8,20,21,11,8,4,0,0
669,nTQLzhC7,PAO,2023,euro,79,34,14,26,52,16,30,10,22,17,24,6,28,23,5,13,3,0,0
670,nZ3OQaGo,AEK,2023,euro,79,21,15,32,63,29,52,3,11,12,17,7,14,21,8,18,1,0,0
671,nZ3OQaGo,MUR,2023,euro,84,27,23,29,62,18,30,11,32,15,17,11,16,24,10,18,2,0,0
672,nc2SKoi4,AEK,2022,euro,80,38,17,28,65,16,34,12,31,12,20,12,26,24,6,12,1,0,0
673,nc2SKoi4,PIN,2022,euro,72,35,16,22,59,10,21,12,38,16,23,8,27,23,7,13,5,0,0
674,ncdcqrnE,PER,2023,euro,68,28,13,25,55,17,35,8,20,10,11,5,23,31,2,14,1,0,0
675,ncdcqrnE,TEN,2023,euro,89,27,17,26,58,17,31,9,27,28,32,7,20,18,7,8,3,0,0
676,neiyQRkT,DAR,2021,euro,85,24,20,31,59,23,40,8,19,15,15,8,16,21,13,15,1,0,0
677,neiyQRkT,SAN,2021,euro,66,22,14,22,45,17,23,5,22,17,19,5,17,17,5,25,0,0,0
678,ngIpmXps,TEN,2021,euro,74,19,20,26,51,12,18,14,33,8,11,2,17,19,2,13,2,0,0
679,ngIpmXps,TOF,2021,euro,73,28,18,27,56,19,39,8,17,11,13,6,22,17,8,12,0,0,0
680,ngbvs9Vu,AEK,2023,euro,108,53,19,36,85,25,50,11,35,25,30,16,37,29,4,18,5,0,0
681,ngbvs9Vu,HAP,2023,euro,112,43,19,40,90,30,51,10,39,22,32,14,29,28,11,10,7,0,0
682,nqZlhk8j,PAO,2022,euro,85,23,13,26,56,15,29,11,27,22,26,7,16,21,8,11,5,0,0
683,nqZlhk8j,UNI,2022,euro,88,31,23,30,57,19,36,11,21,17,23,11,20,24,8,11,2,0,0
684,p0SHxNHm,GAL,2021,euro,58,42,16,17,54,12,31,5,23,19,24,11,31,19,7,19,5,0,0
685,p0SHxNHm,LUD,2021,euro,60,34,10,24,66,22,44,2,22,10,15,8,26,16,10,10,0,0,0
686,p4MZBrcU,CAP,2023,bal,48,31,13,16,57,12,39,4,18,12,26,10,21,22,6,17,1,3,0
687,p4MZBrcU,PET,2023,bal,87,52,23,31,71,23,33,8,38,17,23,16,36,23,9,16,3,1,0
688,p4UZ7sL6,MAN,2023,euro,73,36,19,29,56,22,36,7,20,8,14,7,29,13,2,14,4,0,0
689,p4UZ7sL6,SZO,2023,euro,75,25,24,31,71,22,45,9,26,4,6,8,17,12,10,7,2,0,0
690,p6VVJxUq,STR,2023,euro,71,25,13,28,66,23,49,5,17,10,12,10,15,22,10,17,0,0,0
691,p6VVJxUq,TOF,2023,euro,93,34,27,30,54,17,29,13,25,20,27,9,25,18,9,17,4,0,0
692,p8tRA8fj,BC,2021,euro,87,33,21,27,57,17,37,10,20,23,31,7,26,21,0,11,5,0,0
693,p8tRA8fj,PRO,2021,euro,91,34,13,36,77,29,50,7,27,12,13,12,22,26,4,5,4,0,0
694,pCWX6CZB,CHO,2023,euro,77,36,22,29,68,22,47,7,21,12,21,12,24,24,5,10,1,0,0
695,pCWX6CZB,TOF,2023,euro,74,39,13,22,63,17,39,5,24,25,29,13,26,19,7,9,1,0,0
696,pIk41TOA,STR,2021,euro,85,28,23,32,65,25,45,7,20,14,21,10,18,11,12,13,4,0,0
697,pIk41TOA,SZO,2021,euro,63,29,8,26,52,20,33,6,19,5,5,5,24,20,7,25,4,0,0
698,pS6f9cZl,DOU,2021,bal,62,28,17,23,68,17,48,6,20,10,16,9,19,24,14,16,2,3,0
699,pS6f9cZl,ZAM,2021,bal,86,36,28,33,59,26,40,7,19,13,25,7,29,21,12,22,3,2,0
700,pSjK4T1a,PER,2022,euro,60,27,15,21,55,14,30,7,25,11,17,11,16,19,5,14,2,0,0
701,pSjK4T1a,TEN,2022,euro,86,33,21,30,60,19,35,11,25,15,20,12,21,16,6,10,1,0,0
702,pSpPgIZ1,FER,2021,bal,55,28,7,21,73,16,49,5,24,8,11,9,19,23,9,15,1,7,0
703,pSpPgIZ1,ZAM,2021,bal,71,49,16,25,59,17,38,8,21,13,21,12,37,19,6,28,7,1,0
704,pbLdHpkt,LIM,2022,euro,67,30,12,25,60,16,36,9,24,8,11,9,21,16,4,14,3,0,0
705,pbLdHpkt,UNI,2022,euro,84,29,23,29,59,17,31,12,28,14,18,4,25,17,11,9,1,0,0
706,pnLQHRkL,DIJ,2022,euro,89,27,23,35,65,31,45,4,20,15,18,9,18,21,11,11,0,0,0
707,pnLQHRkL,PER,2022,euro,82,23,22,26,49,15,26,11,23,19,24,5,18,20,3,17,2,0,0
708,pvoqZJJ5,RIG,2023,euro,77,35,21,25,57,15,31,10,26,17,25,11,24,20,7,12,0,0,0
709,pvoqZJJ5,TEN,2023,euro,72,29,16,23,54,13,26,10,28,16,21,6,23,24,6,14,1,0,0
710,r3EBgQFr,BON,2023,euro,89,35,23,30,71,24,44,6,27,23,29,9,26,24,9,7,2,0,0
711,r3EBgQFr,GAL,2023,euro,76,36,16,25,61,17,36,8,25,18,31,8,28,22,5,13,3,0,0
712,rHZhr95c,LAV,2021,euro,78,28,21,30,69,20,41,10,28,8,13,7,21,21,6,7,2,0,0
713,rHZhr95c,TRE,2021,euro,90,39,17,32,64,22,38,10,26,16,20,9,30,15,2,11,4,0,0
714,rHsPKGp0,CAP,2022,bal,92,40,18,31,75,19,41,12,34,18,24,10,30,15,10,14,6,0,0
715,rHsPKGp0,ESP,2022,bal,96,56,30,36,101,26,61,10,40,14,23,24,32,19,7,13,5,0,0
716,rR6ZhEua,MUR,2022,euro,65,31,14,24,66,14,45,10,21,7,12,14,17,26,9,17,0,0,0
717,rR6ZhEua,TEN,2022,euro,85,30,11,30,56,16,28,14,28,11,14,7,23,18,6,18,2,0,0
718,rcV6m8EC,ABI,2023,bal,76,40,18,26,65,16,32,10,33,14,18,8,32,19,11,21,5,1,0
719,rcV6m8EC,DOU,2023,bal,70,44,12,25,71,18,44,7,27,13,24,14,30,20,12,18,1,5,0
720,rcmHps9R,ALA,2023,bal,78,37,17,26,59,22,38,4,21,22,35,7,30,27,5,16,4,3,0
721,rcmHps9R,STA,2023,bal,73,39,19,21,66,16,41,5,25,26,37,13,26,28,5,16,3,4,0
722,reGPXO4j,MAN,2021,euro,68,33,22,27,65,18,35,9,30,5,7,11,22,14,7,19,6,0,0
723,reGPXO4j,TOF,2021,euro,74,28,20,31,68,25,48,6,20,6,6,11,17,12,11,15,8,0,0
724,rgaxUKND,CAP,2022,bal,83,32,16,27,65,22,46,5,19,24,34,6,26,20,12,13,0,6,0
725,rgaxUKND,COB,2022,bal,79,41,25,30,69,25,42,5,27,14,27,13,28,24,7,16,6,0,0
726,riAfU181,CLU,2021,euro,73,32,13,25,49,16,29,9,20,14,26,8,24,26,9,25,1,0,0
727,riAfU181,LUD,2021,euro,79,25,15,24,60,16,33,8,27,23,32,8,17,24,11,11,3,0,0
728,runL8oLq,AEK,2022,euro,51,27,9,14,50,9,21,5,29,18,25,7,20,26,6,16,1,0,0
729,runL8oLq,HAP,2022,euro,91,26,19,31,54,20,37,11,17,18,28,2,24,25,10,9,3,0,0
730,t0HORg4l,IGO,2022,euro,73,38,20,28,70,22,47,6,23,11,18,6,32,17,9,9,2,0,0
731,t0HORg4l,NYM,2022,euro,69,47,20,23,68,16,37,7,31,16,24,14,33,16,5,15,2,0,0
732,t0we2YyP,PIN,2021,euro,69,28,16,26,61,16,35,10,26,7,10,4,24,26,2,8,4,0,0
733,t0we2YyP,TEN,2021,euro,76,38,21,28,64,23,40,5,24,15,19,8,30,16,4,7,1,0,0
734,t20SJz06,FAP,2022,bal,63,42,12,26,78,22,55,4,23,7,14,15,27,14,9,13,3,3,0
735,t20SJz06,ZAM,2022,bal,77,45,17,27,70,19,39,8,31,15,15,10,35,15,7,16,3,3,0
736,t45IaQO3,DAR,2023,euro,63,40,4,24,64,23,45,1,19,14,19,12,28,9,4,17,2,0,0
737,t45IaQO3,LUD,2023,euro,82,43,18,35,83,27,50,8,33,4,5,18,25,22,5,8,6,0,0
738,t4kYaN7D,LAV,2021,euro,70,27,13,27,57,21,39,6,18,10,16,8,19,16,6,10,2,0,0
739,t4kYaN7D,UNI,2021,euro,58,35,12,25,62,20,36,5,26,3,4,13,22,18,5,16,3,0,0
740,t620srCP,DIJ,2023,euro,77,20,21,27,56,16,30,11,26,12,21,4,16,26,7,10,3,0,0
741,t620srCP,RYT,2023,euro,79,42,19,28,64,19,31,9,33,14,21,16,26,20,6,15,3,0,0
742,tCPIFQc5,CIT,2023,bal,71,32,13,23,68,15,37,8,31,17,22,7,25,22,6,7,2,5,0
743,tCPIFQc5,PET,2023,bal,89,52,19,28,69,17,32,11,37,22,24,13,39,19,6,12,5,2,0
744,tEvUo8ja,HAP,2022,euro,91,30,26,30,56,17,29,13,27,18,26,12,18,18,8,18,1,0,0
745,tEvUo8ja,IGO,2022,euro,80,27,21,28,58,23,34,5,24,19,23,10,17,21,12,16,1,0,0
746,tGiC1zA4,BRE,2023,euro,76,34,12,27,63,17,35,10,28,12,14,8,26,19,5,10,0,0,0
747,tGiC1zA4,PIN,2023,euro,86,36,20,28,62,13,31,15,31,15,19,8,28,18,5,10,5,0,0
748,tKwdF270,RIG,2021,euro,59,35,16,23,56,15,26,8,30,5,12,9,26,15,3,17,8,0,0
749,tKwdF270,SZO,2021,euro,68,36,22,25,71,18,51,7,20,11,11,13,23,18,9,10,4,0,0
750,tOmyXVQi,ALA,2023,bal,80,49,18,26,65,17,33,9,32,19,26,16,33,26,5,20,4,0,0
751,tOmyXVQi,DOU,2023,bal,65,43,12,21,76,19,45,2,31,21,33,18,25,25,13,12,1,0,0
752,tQE5FOJh,AEK,2022,euro,69,34,20,25,60,16,35,9,25,10,12,6,28,21,9,17,1,0,0
753,tQE5FOJh,LIM,2022,euro,63,25,20,21,54,12,27,9,27,12,20,3,22,19,9,13,4,0,0
754,tSDtV5ch,PET,2023,bal,95,40,22,34,68,23,44,11,24,16,22,14,26,19,7,18,4,2,0
755,tSDtV5ch,SLA,2023,bal,78,29,20,31,66,28,50,3,16,13,18,6,23,20,14,14,2,4,0
756,tbW5Ls52,GAL,2021,euro,74,28,16,27,62,15,30,12,32,8,9,8,20,16,16,16,1,0,0
757,tbW5Ls52,HAP,2021,euro,71,31,23,28,58,20,32,8,26,7,13,7,24,15,8,18,1,0,0
758,tfWfkxrR,CHO,2023,euro,63,37,16,20,63,13,35,7,28,16,23,11,26,20,8,15,1,0,0
759,tfWfkxrR,RIG,2023,euro,67,29,19,24,55,16,31,8,24,11,16,6,23,17,8,14,6,0,0
760,tffH4aGE,TEN,2021,euro,78,24,22,24,50,13,24,11,26,19,26,7,17,15,7,13,1,0,0
761,tffH4aGE,TOF,2021,euro,77,31,11,31,65,26,47,5,18,10,12,13,18,22,6,15,0,0,0
762,thcX3Tbg,DOU,2023,bal,55,50,15,19,80,15,52,4,28,13,19,22,28,13,7,14,2,4,0
763,thcX3Tbg,REG,2023,bal,69,42,20,26,66,15,33,11,33,6,9,8,34,15,7,14,4,2,0
764,tjEuVDj1,HAP,2021,euro,68,32,12,25,59,19,37,6,22,12,14,11,21,21,2,20,0,0,0
765,tjEuVDj1,LUD,2021,euro,88,20,19,31,60,17,36,14,24,12,19,7,13,18,11,7,2,0,0
766,tl5rZZms,GAL,2022,euro,76,33,14,29,66,20,40,9,26,9,14,6,27,19,5,10,1,0,0
767,tl5rZZms,UNI,2022,euro,81,36,15,27,67,16,33,11,34,16,16,8,28,19,4,10,4,0,0
768,tn4jZvy3,BC,2023,euro,88,29,15,30,66,21,37,9,29,19,24,13,16,17,8,6,1,0,0
769,tn4jZvy3,OLD,2023,euro,83,29,21,31,64,20,34,11,30,10,10,8,21,23,4,16,0,0,0
770,tvOqAUxn,STR,2022,euro,71,25,23,25,54,17,35,8,19,13,17,6,19,24,7,19,4,0,0
771,tvOqAUxn,SZO,2022,euro,89,39,15,32,67,24,49,8,18,17,27,19,20,14,11,9,1,0,0
772,tzYXhW2m,BAN,2022,euro,72,29,13,26,56,19,34,7,22,13,24,9,20,16,7,16,1,0,0
773,tzYXhW2m,DIJ,2022,euro,85,22,16,30,58,21,34,9,24,16,19,4,18,22,10,11,1,0,0
774,v16ImJYb,AEK,2023,euro,86,34,18,28,65,22,41,6,24,24,30,8,26,19,8,10,4,0,0
775,v16ImJYb,SZC,2023,euro,64,38,15,26,69,21,48,5,21,7,14,14,24,27,7,18,2,0,0
776,v1OHIbZO,OPA,2023,euro,97,41,20,27,67,17,35,10,32,33,39,11,30,22,6,11,2,0,0
777,v1OHIbZO,PRO,2023,euro,100,33,28,37,77,23,39,14,38,12,22,10,23,26,7,7,3,0,0
778,v1pmYwZB,DAR,2023,euro,87,28,19,28,58,16,28,12,30,19,25,6,22,18,7,10,2,0,0
779,v1pmYwZB,RIG,2023,euro,81,45,20,32,72,22,40,10,32,7,15,18,27,23,6,13,3,0,0
780,vDSQpXeN,BON,2022,euro,76,26,18,28,69,18,36,10,33,10,19,10,16,16,10,10,1,0,0
781,vDSQpXeN,STR,2022,euro,77,35,12,32,58,26,41,6,17,7,8,6,29,21,4,19,2,0,0
782,vLYeLSJD,CAP,2022,bal,70,27,21,23,54,17,32,6,22,18,24,3,24,23,12,17,5,0,0
783,vLYeLSJD,FAP,2022,bal,70,37,12,24,67,19,47,5,20,17,25,16,21,21,12,21,2,0,0
784,vNDTmVze,CLU,2021,euro,70,33,18,22,59,13,33,9,26,17,21,7,26,16,6,15,2,0,0
785,vNDTmVze,UNI,2021,euro,79,43,22,32,66,22,48,10,25,12,15,13,30,23,11,8,3,0,0
786,vTUYvxIn,BRI,2021,euro,94,23,24,37,66,22,39,15,27,5,6,5,18,29,4,11,2,0,0
787,vTUYvxIn,CLU,2021,euro,104,33,23,33,61,19,29,14,32,24,33,11,22,15,6,11,0,0,0
788,vVmTRmLG,BES,2021,euro,70,34,15,27,61,19,40,8,21,8,13,12,22,16,5,15,6,0,0
789,vVmTRmLG,HAP,2021,euro,72,27,18,28,62,22,39,6,23,10,13,8,19,16,8,10,6,0,0
790,vXvFKeT2,FER,2022,bal,71,29,15,27,63,18,42,9,21,8,9,6,23,17,5,10,2,6,0
791,vXvFKeT2,USM,2022,bal,77,35,15,30,64,27,45,3,19,14,19,9,26,14,3,14,6,2,0
792,vZDvHU3e,BAK,2022,euro,86,45,18,30,71,25,53,5,18,21,30,8,37,18,8,19,4,0,0
793,vZDvHU3e,LUD,2022,euro,94,50,21,36,94,27,56,9,38,13,15,20,30,20,10,15,1,0,0
794,vZNoYg3m,GAL,2022,euro,72,33,14,24,60,13,31,11,29,13,16,7,26,16,2,9,3,0,0
795,vZNoYg3m,UNI,2022,euro,67,44,18,27,72,20,41,7,31,6,9,15,29,19,7,12,4,0,0
796,veLOq7L6,DAR,2023,euro,73,30,15,25,55,19,34,6,21,17,23,6,24,15,5,13,6,0,0
797,veLOq7L6,LUD,2023,euro,99,36,23,36,76,18,38,18,38,9,10,12,24,20,8,9,5,0,0
798,veN1Bijk,DUC,2022,bal,92,45,21,31,69,25,43,6,26,24,36,14,31,27,9,16,3,1,0
799,veN1Bijk,REG,2022,bal,86,33,16,29,67,21,37,8,30,20,30,5,28,26,4,15,1,3,0
800,vg0rihAB,BIL,2022,euro,72,26,16,22,59,15,38,7,21,21,26,8,18,18,8,17,2,0,0
801,vg0rihAB,MUR,2022,euro,90,30,16,33,60,23,36,10,24,14,15,6,24,24,12,15,5,0,0
802,vkfAERi8,MUR,2023,euro,80,23,15,30,52,23,31,7,21,13,16,6,17,21,10,11,2,0,0
803,vkfAERi8,PRO,2023,euro,81,25,9,26,57,17,33,9,24,20,26,8,17,20,8,16,2,0,0
804,vkrYwsAG,PAO,2022,euro,63,31,11,24,63,13,33,11,30,4,9,14,17,22,7,16,1,0,0
805,vkrYwsAG,RYT,2022,euro,82,35,13,28,60,18,35,10,25,16,22,12,23,19,7,14,2,0,0
806,vya5uDN9,ABI,2023,bal,70,26,18,24,60,18,35,6,25,16,23,12,14,16,6,9,1,0,0
807,vya5uDN9,PET,2023,bal,88,41,20,33,68,24,44,9,24,13,18,14,27,20,4,15,6,0,0
808,vycXuBJc,MAN,2021,euro,106,40,21,35,72,20,37,15,35,21,22,14,26,23,8,13,3,0,0
809,vycXuBJc,TRE,2021,euro,85,34,18,33,76,24,52,9,24,10,14,13,21,21,7,20,0,0,0
810,vysko173,MAN,2022,euro,85,28,14,29,59,19,34,10,25,17,21,6,22,18,7,9,0,0,0
811,vysko173,TEN,2022,euro,83,26,20,30,57,21,31,9,26,14,16,5,21,20,5,14,1,0,0
812,x0zEWrjG,BC,2022,euro,95,41,19,30,69,20,41,10,28,25,29,11,30,21,6,12,4,0,0
813,x0zEWrjG,HAP,2022,euro,86,30,21,31,67,22,37,9,30,15,19,5,25,23,7,12,6,0,0
814,x6kr1MZs,RIG,2021,euro,74,34,14,26,60,16,31,10,29,12,15,7,27,20,6,13,3,0,0
815,x6kr1MZs,TRE,2021,euro,71,32,17,23,57,14,32,9,25,16,18,5,27,19,9,14,3,0,0
816,xIJtFL2U,BAN,2021,euro,56,22,16,17,53,14,35,3,18,19,28,4,18,17,7,16,4,0,0
817,xIJtFL2U,PRO,2021,euro,89,44,15,35,66,24,45,11,21,8,12,12,32,22,7,16,1,0,0
818,xOU1Lexm,HAP,2021,euro,79,40,16,29,63,20,37,9,26,12,18,6,34,22,2,21,1,0,0
819,xOU1Lexm,PRO,2021,euro,82,35,18,28,78,18,39,10,39,16,20,11,24,21,9,8,7,0,0
820,xWroCEYD,TOF,2023,euro,85,40,16,30,62,26,45,4,17,21,28,5,35,24,2,15,4,0,0
821,xWroCEYD,TOR,2023,euro,91,30,25,32,79,23,51,9,28,18,23,9,21,21,7,4,3,0,0
822,xlEJ0Ls4,BON,2022,euro,86,39,23,34,68,25,46,9,22,9,13,14,25,20,5,17,1,0,0
823,xlEJ0Ls4,RYT,2022,euro,79,25,17,29,62,19,34,10,28,11,19,8,17,22,5,12,5,0,0
824,xvRR93jf,MAN,2023,euro,86,32,17,30,54,20,34,10,20,16,19,9,23,20,4,13,1,0,0
825,xvRR93jf,PER,2023,euro,78,25,17,27,62,19,30,8,32,16,22,10,15,23,5,11,6,0,0
826,z1aD4ogr,DIJ,2021,euro,73,35,16,30,68,22,37,8,31,5,10,13,22,15,13,10,5,0,0
827,z1aD4ogr,LAV,2021,euro,49,29,10,19,49,16,32,3,17,8,11,4,25,12,4,20,2,0,0
828,z7OL5CBs,IGO,2023,euro,74,33,18,27,63,20,44,7,19,13,17,12,21,26,4,13,2,0,0
829,z7OL5CBs,TOR,2023,euro,77,35,16,28,64,21,42,7,22,14,20,13,22,21,8,12,4,0,0
830,z7SFwGuQ,BON,2022,euro,85,32,23,26,66,17,44,9,22,24,28,12,20,24,6,12,2,0,0
831,z7SFwGuQ,MAN,2022,euro,75,33,15,30,62,26,45,4,17,11,15,11,22,25,2,16,6,0,0
832,z7pcdiIB,BAN,2023,euro,93,32,29,28,52,14,27,14,25,23,29,6,26,18,7,19,3,0,0
833,z7pcdiIB,CHO,2023,euro,72,25,20,27,66,17,34,10,32,8,16,9,16,21,12,15,2,0,0
834,zD3qbFAl,DIJ,2021,euro,75,27,17,27,62,17,36,10,26,11,16,8,19,20,6,9,3,0,0
835,zD3qbFAl,GAL,2021,euro,72,35,15,25,59,19,44,6,15,16,22,13,22,19,5,12,2,0,0
836,zHmJC5MK,MUR,2023,euro,78,21,22,27,58,18,30,9,28,15,18,6,15,19,7,13,5,0,0
837,zHmJC5MK,PRO,2023,euro,79,29,15,30,60,22,41,8,19,11,13,10,19,18,9,15,0,0,0
838,zL71AHd1,HAP,2021,euro,71,34,20,24,48,12,23,12,25,11,17,2,32,17,2,15,3,0,0
839,zL71AHd1,LUD,2021,euro,68,33,14,24,71,13,40,11,31,9,16,11,22,18,8,4,1,0,0
840,ziIhBB6J,STA,2023,bal,68,33,15,27,79,22,48,5,31,9,17,13,20,18,7,15,0,4,0
841,ziIhBB6J,USM,2023,bal,78,40,14,27,57,21,34,6,23,18,23,6,34,19,9,20,4,0,0
842,zk7xn957,RYT,2021,euro,81,23,20,27,62,15,32,12,30,15,22,6,17,25,7,12,2,0,0
843,zk7xn957,SZO,2021,euro,86,31,19,31,59,26,44,5,15,19,25,6,25,22,7,10,4,0,0
